4	4967	0	4967	0	4967	1	0
5	5972	0	1005	0	5972	0	0
6	7448	0	1476	0	7448	0	0
7	8452	0	1004	0	8452	0	0
8	10226	0	1774	0	10226	0	0
9	11230	0	1004	0	11230	0	0
10	12234	0	1004	0	12234	0	0
11	13237	0	1003	0	13237	0	0
12	14243	0	1006	0	14243	1	0
13	15247	0	1004	0	15247	0	0
14	16251	0	1004	0	16251	0	0
15	17256	0	1005	0	17256	0	0
16	18261	0	1005	0	18261	0	0
17	19265	0	1004	0	19265	0	0
18	20269	0	1004	0	20269	0	0
19	21272	0	1003	0	21272	0	0
20	22277	0	1005	0	22277	0	0
21	23280	0	1003	0	23280	0	0
22	24284	0	1004	0	24284	0	0
23	28848	0	4564	0	28848	0	0
24	29853	0	1005	0	29853	0	0
25	30860	0	1007	0	30860	0	0
26	31876	0	1016	0	31876	0	0
27	32880	0	1004	0	32880	0	0
28	33885	0	1005	0	33885	0	0
29	34890	0	1005	0	34890	1	0
30	35894	0	1004	0	35894	0	0
31	36899	0	1005	0	36899	0	0
32	37904	0	1005	0	37904	0	0
33	38908	0	1004	0	38908	0	0
34	39913	0	1005	0	39913	0	0
35	40917	0	1004	0	40917	0	0
36	41920	0	1003	0	41920	0	0
37	42924	0	1004	0	42924	0	0
38	43928	0	1004	0	43928	0	0
39	44932	0	1004	0	44932	0	0
40	45937	0	1005	0	45937	0	0
41	46941	0	1004	0	46941	0	0
42	47945	0	1004	0	47945	0	0
43	48949	0	1004	0	48949	0	0
44	49953	0	1004	0	49953	0	0
45	50956	0	1003	0	50956	0	0
46	51960	0	1004	0	51960	0	0
47	52963	0	1003	0	52963	0	0
48	53968	0	1005	0	53968	0	0
49	54972	0	1004	0	54972	0	0
50	55977	0	1005	0	55977	0	0
51	56981	0	1004	0	56981	0	0
52	57986	0	1005	0	57986	0	0
53	58990	0	1004	0	58990	0	0
54	59994	0	1004	0	59994	0	0
55	60999	0	1005	0	60999	0	0
56	62003	0	1004	0	62003	0	0
57	63008	0	1005	0	63008	0	0
58	64012	0	1004	0	64012	0	0
59	65017	0	1005	0	65017	0	0
60	66022	0	1005	0	66022	0	0
61	67027	0	1005	0	67027	0	0
62	68032	0	1005	0	68032	0	0
63	69037	0	1005	0	69037	0	0
64	70042	0	1005	0	70042	0	0
65	71046	0	1004	0	71046	0	0
66	72050	0	1004	0	72050	0	0
67	73054	0	1004	0	73054	0	0
68	74059	0	1005	0	74059	0	0
69	75064	0	1005	0	75064	0	0
70	76068	0	1004	0	76068	0	0
71	77071	0	1003	0	77071	0	0
72	78075	0	1004	0	78075	0	0
73	79079	0	1004	0	79079	0	0
74	80083	0	1004	0	80083	0	0
75	81087	0	1004	0	81087	0	0
76	82092	0	1005	0	82092	0	0
77	83095	0	1003	0	83095	0	0
78	84100	0	1005	0	84100	0	0
79	85105	0	1005	0	85105	0	0
80	86109	0	1004	0	86109	0	0
81	87113	0	1004	0	87113	0	0
82	88119	0	1006	0	88119	0	0
83	89124	0	1005	0	89124	0	0
84	90129	0	1005	0	90129	0	0
85	91132	0	1003	0	91132	0	0
86	92138	0	1006	0	92138	0	0
87	93143	0	1005	0	93143	0	0
88	94148	0	1005	0	94148	0	0
89	95155	0	1007	0	95155	0	0
90	96160	0	1005	0	96160	0	0
91	97165	0	1005	0	97165	0	0
92	98168	0	1003	0	98168	0	0
93	99173	0	1005	0	99173	0	0
94	100177	0	1004	0	100177	0	0
95	101181	0	1004	0	101181	0	0
96	102185	0	1004	0	102185	0	0
97	103189	0	1004	0	103189	0	0
98	104193	0	1004	0	104193	0	0
99	105197	0	1004	0	105197	0	0
100	106202	0	1005	0	106202	0	0
101	107206	0	1004	0	107206	0	0
102	108210	0	1004	0	108210	0	0
103	109213	0	1003	0	109213	0	0
104	110217	0	1004	0	110217	0	0
105	111220	0	1003	0	111220	0	0
106	112223	0	1003	0	112223	0	0
107	113227	0	1004	0	113227	0	0
108	114232	0	1005	0	114232	0	0
109	115237	0	1005	0	115237	0	0
110	116241	0	1004	0	116241	0	0
111	117246	0	1005	0	117246	0	0
112	118250	0	1004	0	118250	0	0
113	119254	0	1004	0	119254	0	0
114	120259	0	1005	0	120259	0	0
115	121264	0	1005	0	121264	0	0
116	122270	0	1006	0	122270	0	0
117	123273	0	1003	0	123273	0	0
118	124279	0	1006	0	124279	0	0
119	125284	0	1005	0	125284	0	0
120	126289	0	1005	0	126289	0	0
121	127294	0	1005	0	127294	0	0
122	128297	0	1003	0	128297	0	0
123	129301	0	1004	0	129301	0	0
124	130305	0	1004	0	130305	0	0
125	131310	0	1005	0	131310	0	0
126	132314	0	1004	0	132314	0	0
127	133318	0	1004	0	133318	0	0
128	134322	0	1004	0	134322	0	0
129	135326	0	1004	0	135326	0	0
130	136331	0	1005	0	136331	0	0
131	137337	0	1006	0	137337	0	0
132	138341	0	1004	0	138341	0	0
133	139347	0	1006	0	139347	0	0
134	140350	0	1003	0	140350	0	0
135	141353	0	1003	0	141353	0	0
136	142357	0	1004	0	142357	0	0
137	143362	0	1005	0	143362	0	0
138	144366	0	1004	0	144366	0	0
139	145369	0	1003	0	145369	0	0
140	146372	0	1003	0	146372	0	0
141	147376	0	1004	0	147376	0	0
142	148380	0	1004	0	148380	0	0
143	149384	0	1004	0	149384	0	0
144	150389	0	1005	0	150389	0	0
145	151393	0	1004	0	151393	0	0
146	152398	0	1005	0	152398	0	0
147	153403	0	1005	0	153403	0	0
148	154407	0	1004	0	154407	0	0
149	155412	0	1005	0	155412	0	0
150	156417	0	1005	0	156417	0	0
151	157421	0	1004	0	157421	0	0
152	158425	0	1004	0	158425	0	0
153	159429	0	1004	0	159429	0	0
154	160432	0	1003	0	160432	0	0
155	161436	0	1004	0	161436	0	0
156	162440	0	1004	0	162440	0	0
157	163444	0	1004	0	163444	0	0
158	164448	0	1004	0	164448	0	0
159	165452	0	1004	0	165452	0	0
160	166457	0	1005	0	166457	0	0
161	167461	0	1004	0	167461	0	0
162	168465	0	1004	0	168465	0	0
163	169470	0	1005	0	169470	0	0
164	170475	0	1005	0	170475	0	0
165	171479	0	1004	0	171479	0	0
166	172482	0	1003	0	172482	0	0
167	173486	0	1004	0	173486	0	0
168	174490	0	1004	0	174490	0	0
169	175495	0	1005	0	175495	0	0
170	176499	0	1004	0	176499	0	0
171	177504	0	1005	0	177504	0	0
172	178524	0	1020	0	178524	0	0
173	179528	0	1004	0	179528	0	0
174	180533	0	1005	0	180533	0	0
175	181538	0	1005	0	181538	0	0
176	182542	0	1004	0	182542	0	0
177	183546	0	1004	0	183546	0	0
178	184551	0	1005	0	184551	0	0
179	185556	0	1005	0	185556	0	0
180	186561	0	1005	0	186561	0	0
181	187566	0	1005	0	187566	0	0
182	188571	0	1005	0	188571	0	0
183	189574	0	1003	0	189574	0	0
184	190578	0	1004	0	190578	0	0
185	191583	0	1005	0	191583	0	0
186	192588	0	1005	0	192588	0	0
187	193592	0	1004	0	193592	0	0
188	194596	0	1004	0	194596	0	0
189	195601	0	1005	0	195601	0	0
190	197363	0	1762	0	197363	0	0
191	198368	0	1005	0	198368	0	0
192	199372	0	1004	0	199372	0	0
193	200377	0	1005	0	200377	0	0
194	201382	0	1005	0	201382	0	0
195	202386	0	1004	0	202386	0	0
196	203391	0	1005	0	203391	0	0
197	204395	0	1004	0	204395	0	0
198	205400	0	1005	0	205400	0	0
199	206405	0	1005	0	206405	0	0
200	207409	0	1004	0	207409	0	0
201	208414	0	1005	0	208414	0	0
202	209418	0	1004	0	209418	0	0
203	210422	0	1004	0	210422	0	0
204	211426	0	1004	0	211426	0	0
205	212431	0	1005	0	212431	0	0
206	213434	0	1003	0	213434	0	0
207	214439	0	1005	0	214439	0	0
208	215444	0	1005	0	215444	0	0
209	216449	0	1005	0	216449	0	0
210	217454	0	1005	0	217454	0	0
211	218458	0	1004	0	218458	0	0
212	219462	0	1004	0	219462	0	0
213	220467	0	1005	0	220467	0	0
214	221471	0	1004	0	221471	0	0
215	222475	0	1004	0	222475	0	0
216	223479	0	1004	0	223479	0	0
217	224485	0	1006	0	224485	0	0
218	225490	0	1005	0	225490	0	0
219	226495	0	1005	0	226495	0	0
220	227499	0	1004	0	227499	0	0
221	228503	0	1004	0	228503	0	0
222	229507	0	1004	0	229507	0	0
223	230511	0	1004	0	230511	0	0
224	231516	0	1005	0	231516	0	0
225	232521	0	1005	0	232521	0	0
226	233525	0	1004	0	233525	0	0
227	234530	0	1005	0	234530	0	0
228	235534	0	1004	0	235534	0	0
229	236538	0	1004	0	236538	0	0
230	237542	0	1004	0	237542	0	0
231	238545	0	1003	0	238545	0	0
232	239549	0	1004	0	239549	0	0
233	240553	0	1004	0	240553	0	0
234	241557	0	1004	0	241557	0	0
235	242562	0	1005	0	242562	0	0
236	243567	0	1005	0	243567	0	0
237	244572	0	1005	0	244572	0	0
238	245576	0	1004	0	245576	0	0
239	246581	0	1005	0	246581	0	0
240	247585	0	1004	0	247585	0	0
241	248590	0	1005	0	248590	0	0
242	249595	0	1005	0	249595	0	0
243	250599	0	1004	0	250599	0	0
244	251604	0	1005	0	251604	0	0
245	252608	0	1004	0	252608	0	0
246	253613	0	1005	0	253613	0	0
247	254618	0	1005	0	254618	0	0
248	255622	0	1004	0	255622	0	0
249	256627	0	1005	0	256627	0	0
250	257632	0	1005	0	257632	0	0
251	258636	0	1004	0	258636	0	0
252	259640	0	1004	0	259640	0	0
253	260643	0	1003	0	260643	0	0
254	261648	0	1005	0	261648	0	0
255	262653	0	1005	0	262653	0	0
256	263657	0	1004	0	263657	0	0
257	264662	0	1005	0	264662	0	0
258	265666	0	1004	0	265666	0	0
259	266670	0	1004	0	266670	0	0
260	267673	0	1003	0	267673	0	0
261	268678	0	1005	0	268678	0	0
262	269682	0	1004	0	269682	0	0
263	270685	0	1003	0	270685	0	0
264	271689	0	1004	0	271689	0	0
265	272692	0	1003	0	272692	0	0
266	273696	0	1004	0	273696	0	0
267	274700	0	1004	0	274700	0	0
268	275705	0	1005	0	275705	0	0
269	276710	0	1005	0	276710	0	0
270	277713	0	1003	0	277713	0	0
271	278717	0	1004	0	278717	0	0
272	279721	0	1004	0	279721	0	0
273	280726	0	1005	0	280726	0	0
274	281730	0	1004	0	281730	0	0
275	282734	0	1004	0	282734	0	0
276	283738	0	1004	0	283738	0	0
277	284742	0	1004	0	284742	0	0
278	285746	0	1004	0	285746	0	0
279	286749	0	1003	0	286749	0	0
280	287752	0	1003	0	287752	0	0
281	288756	0	1004	0	288756	0	0
282	289761	0	1005	0	289761	0	0
283	290766	0	1005	0	290766	0	0
284	291771	0	1005	0	291771	0	0
285	292776	0	1005	0	292776	0	0
286	293780	0	1004	0	293780	0	0
287	294784	0	1004	0	294784	0	0
288	295787	0	1003	0	295787	0	0
289	296791	0	1004	0	296791	0	0
290	297797	0	1006	0	297797	0	0
291	298801	0	1004	0	298801	0	0
292	299806	0	1005	0	299806	0	0
293	300810	0	1004	0	300810	0	0
294	301815	0	1005	0	301815	0	0
295	302820	0	1005	0	302820	0	0
296	303824	0	1004	0	303824	0	0
297	304828	0	1004	0	304828	0	0
298	305833	0	1005	0	305833	0	0
299	306838	0	1005	0	306838	0	0
300	307842	0	1004	0	307842	0	0
301	308847	0	1005	0	308847	0	0
302	309852	0	1005	0	309852	0	0
303	310857	0	1005	0	310857	0	0
304	311871	0	1014	0	311871	0	0
305	312875	0	1004	0	312875	0	0
306	313880	0	1005	0	313880	0	0
307	314885	0	1005	0	314885	0	0
308	315889	0	1004	0	315889	0	0
309	316894	0	1005	0	316894	0	0
310	317899	0	1005	0	317899	0	0
311	318903	0	1004	0	318903	0	0
312	319906	0	1003	0	319906	0	0
313	320910	0	1004	0	320910	0	0
314	321914	0	1004	0	321914	0	0
315	322919	0	1005	0	322919	0	0
316	323923	0	1004	0	323923	0	0
317	324927	0	1004	0	324927	0	0
318	325931	0	1004	0	325931	0	0
319	326936	0	1005	0	326936	0	0
320	327941	0	1005	0	327941	0	0
321	328945	0	1004	0	328945	0	0
322	329950	0	1005	0	329950	0	0
323	330954	0	1004	0	330954	0	0
324	331959	0	1005	0	331959	0	0
325	332963	0	1004	0	332963	0	0
326	333968	0	1005	0	333968	0	0
327	334973	0	1005	0	334973	0	0
328	335978	0	1005	0	335978	0	0
329	336983	0	1005	0	336983	0	0
330	337987	0	1004	0	337987	0	0
331	338992	0	1005	0	338992	0	0
332	339996	0	1004	0	339996	0	0
333	341001	0	1005	0	341001	0	0
334	342006	0	1005	0	342006	0	0
335	343010	0	1004	0	343010	0	0
336	344015	0	1005	0	344015	0	0
337	345019	0	1004	0	345019	0	0
338	346024	0	1005	0	346024	0	0
339	347028	0	1004	0	347028	0	0
340	348032	0	1004	0	348032	0	0
341	349036	0	1004	0	349036	0	0
342	350041	0	1005	0	350041	0	0
343	351046	0	1005	0	351046	0	0
344	352050	0	1004	0	352050	0	0
345	353054	0	1004	0	353054	0	0
346	354059	0	1005	0	354059	0	0
347	355064	0	1005	0	355064	0	0
348	356069	0	1005	0	356069	0	0
349	357075	0	1006	0	357075	0	0
350	358080	0	1005	0	358080	0	0
351	359085	0	1005	0	359085	0	0
352	360088	0	1003	0	360088	0	0
353	361093	0	1005	0	361093	0	0
354	362097	0	1004	0	362097	0	0
355	363101	0	1004	0	363101	0	0
356	364105	0	1004	0	364105	0	0
357	365109	0	1004	0	365109	0	0
358	366117	0	1008	0	366117	0	0
359	367122	0	1005	0	367122	0	0
360	368127	0	1005	0	368127	0	0
361	369132	0	1005	0	369132	0	0
362	370135	0	1003	0	370135	0	0
363	371141	0	1006	0	371141	0	0
364	372147	0	1006	0	372147	0	0
365	373152	0	1005	0	373152	0	0
366	374156	0	1004	0	374156	0	0
367	375160	0	1004	0	375160	0	0
368	376163	0	1003	0	376163	0	0
369	377168	0	1005	0	377168	0	0
370	378171	0	1003	0	378171	0	0
371	379175	0	1004	0	379175	0	0
372	380178	0	1003	0	380178	0	0
373	381183	0	1005	0	381183	0	0
374	382187	0	1004	0	382187	0	0
375	383192	0	1005	0	383192	0	0
376	384197	0	1005	0	384197	0	0
377	385202	0	1005	0	385202	0	0
378	386207	0	1005	0	386207	0	0
379	387212	0	1005	0	387212	0	0
380	388216	0	1004	0	388216	0	0
381	389220	0	1004	0	389220	0	0
382	390225	0	1005	0	390225	0	0
383	391229	0	1004	0	391229	0	0
384	392234	0	1005	0	392234	0	0
385	393239	0	1005	0	393239	0	0
386	394242	0	1003	0	394242	0	0
387	395246	0	1004	0	395246	0	0
388	396251	0	1005	0	396251	0	0
389	397255	0	1004	0	397255	0	0
390	398259	0	1004	0	398259	0	0
391	399263	0	1004	0	399263	0	0
392	400268	0	1005	0	400268	0	0
393	401273	0	1005	0	401273	0	0
394	402278	0	1005	0	402278	0	0
395	403282	0	1004	0	403282	0	0
396	404286	0	1004	0	404286	0	0
397	405290	0	1004	0	405290	0	0
398	406294	0	1004	0	406294	0	0
399	407299	0	1005	0	407299	0	0
400	408304	0	1005	0	408304	0	0
401	409309	0	1005	0	409309	0	0
402	410313	0	1004	0	410313	0	0
403	411318	0	1005	0	411318	0	0
404	412322	0	1004	0	412322	0	0
405	413327	0	1005	0	413327	0	0
406	414332	0	1005	0	414332	0	0
407	415337	0	1005	0	415337	0	0
408	416340	0	1003	0	416340	0	0
409	417344	0	1004	0	417344	0	0
410	418349	0	1005	0	418349	0	0
411	419354	0	1005	0	419354	0	0
412	420359	0	1005	0	420359	0	0
413	421363	0	1004	0	421363	0	0
414	422368	0	1005	0	422368	0	0
415	423372	0	1004	0	423372	0	0
416	424377	0	1005	0	424377	0	0
417	425381	0	1004	0	425381	0	0
418	426384	0	1003	0	426384	0	0
419	427389	0	1005	0	427389	0	0
420	428393	0	1004	0	428393	0	0
421	429398	0	1005	0	429398	0	0
422	430403	0	1005	0	430403	0	0
423	431408	0	1005	0	431408	0	0
424	432412	0	1004	0	432412	0	0
425	433417	0	1005	0	433417	0	0
426	434421	0	1004	0	434421	0	0
427	435426	0	1005	0	435426	0	0
428	436430	0	1004	0	436430	0	0
429	437434	0	1004	0	437434	0	0
430	438437	0	1003	0	438437	0	0
431	439442	0	1005	0	439442	0	0
432	440447	0	1005	0	440447	0	0
433	441451	0	1004	0	441451	0	0
434	442456	0	1005	0	442456	0	0
435	443461	0	1005	0	443461	0	0
436	444464	0	1003	0	444464	0	0
437	445468	0	1004	0	445468	0	0
438	446471	0	1003	0	446471	0	0
439	447476	0	1005	0	447476	0	0
440	448481	0	1005	0	448481	0	0
441	449485	0	1004	0	449485	0	0
442	450490	0	1005	0	450490	0	0
443	451495	0	1005	0	451495	0	0
444	452500	0	1005	0	452500	0	0
445	453504	0	1004	0	453504	0	0
446	454509	0	1005	0	454509	0	0
447	455513	0	1004	0	455513	0	0
448	456518	0	1005	0	456518	0	0
449	457523	0	1005	0	457523	0	0
450	458528	0	1005	0	458528	0	0
451	459533	0	1005	0	459533	0	0
452	460538	0	1005	0	460538	0	0
453	461543	0	1005	0	461543	0	0
454	462546	0	1003	0	462546	0	0
455	463551	0	1005	0	463551	0	0
456	464556	0	1005	0	464556	0	0
457	465559	0	1003	0	465559	0	0
458	466562	0	1003	0	466562	0	0
459	467565	0	1003	0	467565	0	0
460	468570	0	1005	0	468570	0	0
461	469575	0	1005	0	469575	0	0
462	470578	0	1003	0	470578	0	0
463	471581	0	1003	0	471581	0	0
464	472586	0	1005	0	472586	0	0
465	473591	0	1005	0	473591	0	0
466	474596	0	1005	0	474596	0	0
467	475600	0	1004	0	475600	0	0
468	476605	0	1005	0	476605	0	0
469	477609	0	1004	0	477609	0	0
470	478614	0	1005	0	478614	0	0
471	479618	0	1004	0	479618	0	0
472	480622	0	1004	0	480622	0	0
473	481627	0	1005	0	481627	0	0
474	482630	0	1003	0	482630	0	0
475	483634	0	1004	0	483634	0	0
476	484639	0	1005	0	484639	0	0
477	485643	0	1004	0	485643	0	0
478	486647	0	1004	0	486647	0	0
479	487651	0	1004	0	487651	0	0
480	488655	0	1004	0	488655	0	0
481	489659	0	1004	0	489659	0	0
482	490663	0	1004	0	490663	0	0
483	491668	0	1005	0	491668	0	0
484	492673	0	1005	0	492673	0	0
485	493678	0	1005	0	493678	0	0
486	494683	0	1005	0	494683	0	0
487	495687	0	1004	0	495687	0	0
488	496692	0	1005	0	496692	0	0
489	497697	0	1005	0	497697	0	0
490	498702	0	1005	0	498702	0	0
491	499707	0	1005	0	499707	0	0
492	500712	0	1005	0	500712	0	0
493	501717	0	1005	0	501717	0	0
494	502721	0	1004	0	502721	0	0
495	503725	0	1004	0	503725	0	0
496	504730	0	1005	0	504730	0	0
497	505734	0	1004	0	505734	0	0
498	506738	0	1004	0	506738	0	0
499	508045	0	1307	0	508045	0	0
500	509050	0	1005	0	509050	0	0
501	510054	0	1004	0	510054	0	0
502	511059	0	1005	0	511059	0	0
503	512062	0	1003	0	512062	0	0
504	513066	0	1004	0	513066	0	0
505	514069	0	1003	0	514069	0	0
506	515074	0	1005	0	515074	0	0
507	516079	0	1005	0	516079	0	0
508	517084	0	1005	0	517084	0	0
509	518088	0	1004	0	518088	0	0
510	519094	0	1006	0	519094	0	0
511	520098	0	1004	0	520098	0	0
512	521103	0	1005	0	521103	0	0
513	522107	0	1004	0	522107	0	0
514	523112	0	1005	0	523112	0	0
515	524121	0	1009	0	524121	0	0
516	525127	0	1006	0	525127	0	0
517	526132	0	1005	0	526132	0	0
518	527137	0	1005	0	527137	0	0
519	528143	0	1006	0	528143	0	0
520	529147	0	1004	0	529147	0	0
521	530151	0	1004	0	530151	0	0
522	531156	0	1005	0	531156	0	0
523	532160	0	1004	0	532160	0	0
524	533165	0	1005	0	533165	0	0
525	534169	0	1004	0	534169	0	0
526	535172	0	1003	0	535172	0	0
527	536175	0	1003	0	536175	0	0
528	537180	0	1005	0	537180	0	0
529	538185	0	1005	0	538185	0	0
530	539191	0	1006	0	539191	0	0
531	540195	0	1004	0	540195	0	0
532	541200	0	1005	0	541200	0	0
533	542204	0	1004	0	542204	0	0
534	543209	0	1005	0	543209	0	0
535	544213	0	1004	0	544213	0	0
536	545218	0	1005	0	545218	0	0
537	546222	0	1004	0	546222	0	0
538	547226	0	1004	0	547226	0	0
539	548229	0	1003	0	548229	0	0
540	549233	0	1004	0	549233	0	0
541	550238	0	1005	0	550238	0	0
542	551242	0	1004	0	551242	0	0
543	552247	0	1005	0	552247	0	0
544	553252	0	1005	0	553252	0	0
545	554257	0	1005	0	554257	0	0
546	555262	0	1005	0	555262	0	0
547	556266	0	1004	0	556266	0	0
548	557271	0	1005	0	557271	0	0
549	558275	0	1004	0	558275	0	0
550	559280	0	1005	0	559280	0	0
551	560285	0	1005	0	560285	0	0
552	561289	0	1004	0	561289	0	0
553	562294	0	1005	0	562294	0	0
554	563299	0	1005	0	563299	0	0
555	564303	0	1004	0	564303	0	0
556	565308	0	1005	0	565308	0	0
557	566313	0	1005	0	566313	0	0
558	567317	0	1004	0	567317	0	0
559	568322	0	1005	0	568322	0	0
560	569326	0	1004	0	569326	0	0
561	570331	0	1005	0	570331	0	0
562	571334	0	1003	0	571334	0	0
563	572338	0	1004	0	572338	0	0
564	573343	0	1005	0	573343	0	0
565	574347	0	1004	0	574347	0	0
566	575351	0	1004	0	575351	0	0
567	576357	0	1006	0	576357	0	0
568	577360	0	1003	0	577360	0	0
569	578364	0	1004	0	578364	0	0
570	579368	0	1004	0	579368	0	0
571	580372	0	1004	0	580372	0	0
572	581377	0	1005	0	581377	0	0
573	582381	0	1004	0	582381	0	0
574	583384	0	1003	0	583384	0	0
575	584387	0	1003	0	584387	0	0
576	585391	0	1004	0	585391	0	0
577	586395	0	1004	0	586395	0	0
578	587400	0	1005	0	587400	0	0
579	588405	0	1005	0	588405	0	0
580	589409	0	1004	0	589409	0	0
581	590414	0	1005	0	590414	0	0
582	591419	0	1005	0	591419	0	0
583	592423	0	1004	0	592423	0	0
584	593428	0	1005	0	593428	0	0
585	594433	0	1005	0	594433	0	0
586	595437	0	1004	0	595437	0	0
587	596442	0	1005	0	596442	0	0
588	597445	0	1003	0	597445	0	0
589	598448	0	1003	0	598448	0	0
590	599453	0	1005	0	599453	0	0
591	600458	0	1005	0	600458	0	0
592	601463	0	1005	0	601463	0	0
593	602467	0	1004	0	602467	0	0
594	603472	0	1005	0	603472	0	0
595	604477	0	1005	0	604477	0	0
596	605481	0	1004	0	605481	0	0
597	606487	0	1006	0	606487	0	0
598	607491	0	1004	0	607491	0	0
599	608495	0	1004	0	608495	0	0
600	609500	0	1005	0	609500	0	0
601	610505	0	1005	0	610505	0	0
602	611509	0	1004	0	611509	0	0
603	612513	0	1004	0	612513	0	0
604	613516	0	1003	0	613516	0	0
605	614521	0	1005	0	614521	0	0
606	615525	0	1004	0	615525	0	0
607	616528	0	1003	0	616528	0	0
608	617532	0	1004	0	617532	0	0
609	618537	0	1005	0	618537	0	0
610	619542	0	1005	0	619542	0	0
611	620546	0	1004	0	620546	0	0
612	621551	0	1005	0	621551	0	0
613	622555	0	1004	0	622555	0	0
614	623560	0	1005	0	623560	0	0
615	624565	0	1005	0	624565	0	0
616	625569	0	1004	0	625569	0	0
617	626574	0	1005	0	626574	0	0
618	627578	0	1004	0	627578	0	0
619	628583	0	1005	0	628583	0	0
620	629588	0	1005	0	629588	0	0
621	630592	0	1004	0	630592	0	0
622	631597	0	1005	0	631597	0	0
623	632601	0	1004	0	632601	0	0
624	633604	0	1003	0	633604	0	0
625	634609	0	1005	0	634609	0	0
626	635614	0	1005	0	635614	0	0
627	636618	0	1004	0	636618	0	0
628	637623	0	1005	0	637623	0	0
629	638628	0	1005	0	638628	0	0
630	639634	0	1006	0	639634	0	0
631	640639	0	1005	0	640639	0	0
632	641644	0	1005	0	641644	0	0
633	642648	0	1004	0	642648	0	0
634	643653	0	1005	0	643653	0	0
635	644658	0	1005	0	644658	0	0
636	645662	0	1004	0	645662	0	0
637	646667	0	1005	0	646667	0	0
638	647672	0	1005	0	647672	0	0
639	648676	0	1004	0	648676	0	0
640	649681	0	1005	0	649681	0	0
641	650685	0	1004	0	650685	0	0
642	651690	0	1005	0	651690	0	0
643	652694	0	1004	0	652694	0	0
644	653699	0	1005	0	653699	0	0
645	654703	0	1004	0	654703	0	0
646	655708	0	1005	0	655708	0	0
647	656713	0	1005	0	656713	0	0
648	657717	0	1004	0	657717	0	0
649	658722	0	1005	0	658722	0	0
650	659727	0	1005	0	659727	0	0
651	660731	0	1004	0	660731	0	0
652	661736	0	1005	0	661736	0	0
653	662741	0	1005	0	662741	0	0
654	663745	0	1004	0	663745	0	0
655	664748	0	1003	0	664748	0	0
656	665751	0	1003	0	665751	0	0
657	666756	0	1005	0	666756	0	0
658	667761	0	1005	0	667761	0	0
659	668765	0	1004	0	668765	0	0
660	669770	0	1005	0	669770	0	0
661	670774	0	1004	0	670774	0	0
662	671779	0	1005	0	671779	0	0
663	672784	0	1005	0	672784	0	0
664	673789	0	1005	0	673789	0	0
665	674793	0	1004	0	674793	0	0
666	675798	0	1005	0	675798	0	0
667	676801	0	1003	0	676801	0	0
668	677805	0	1004	0	677805	0	0
669	678808	0	1003	0	678808	0	0
670	679813	0	1005	0	679813	0	0
671	680818	0	1005	0	680818	0	0
672	681822	0	1004	0	681822	0	0
673	682827	0	1005	0	682827	0	0
674	683831	0	1004	0	683831	0	0
675	684836	0	1005	0	684836	0	0
676	685840	0	1004	0	685840	0	0
677	686843	0	1003	0	686843	0	0
678	687848	0	1005	0	687848	0	0
679	688853	0	1005	0	688853	0	0
680	689857	0	1004	0	689857	0	0
681	690871	0	1014	0	690871	0	0
682	691875	0	1004	0	691875	0	0
683	692880	0	1005	0	692880	0	0
684	693885	0	1005	0	693885	0	0
685	694890	0	1005	0	694890	0	0
686	695894	0	1004	0	695894	0	0
687	696899	0	1005	0	696899	0	0
688	697903	0	1004	0	697903	0	0
689	698908	0	1005	0	698908	0	0
690	699913	0	1005	0	699913	0	0
691	700918	0	1005	0	700918	0	0
692	701922	0	1004	0	701922	0	0
693	702927	0	1005	0	702927	0	0
694	703932	0	1005	0	703932	0	0
695	704936	0	1004	0	704936	0	0
696	705940	0	1004	0	705940	0	0
697	706944	0	1004	0	706944	0	0
698	707949	0	1005	0	707949	0	0
699	708953	0	1004	0	708953	0	0
700	709957	0	1004	0	709957	0	0
701	710960	0	1003	0	710960	0	0
702	711965	0	1005	0	711965	0	0
703	712969	0	1004	0	712969	0	0
704	713974	0	1005	0	713974	0	0
705	714979	0	1005	0	714979	0	0
706	715984	0	1005	0	715984	0	0
707	716988	0	1004	0	716988	0	0
708	717992	0	1004	0	717992	0	0
709	718997	0	1005	0	718997	0	0
710	720002	0	1005	0	720002	0	0
711	721006	0	1004	0	721006	0	0
712	722010	0	1004	0	722010	0	0
713	723015	0	1005	0	723015	0	0
714	724020	0	1005	0	724020	0	0
715	725024	0	1004	0	725024	0	0
716	726028	0	1004	0	726028	0	0
717	727031	0	1003	0	727031	0	0
718	728035	0	1004	0	728035	0	0
719	729038	0	1003	0	729038	0	0
720	730043	0	1005	0	730043	0	0
721	731048	0	1005	0	731048	0	0
722	732052	0	1004	0	732052	0	0
723	733057	0	1005	0	733057	0	0
724	734061	0	1004	0	734061	0	0
725	735064	0	1003	0	735064	0	0
726	736068	0	1004	0	736068	0	0
727	737073	0	1005	0	737073	0	0
728	738078	0	1005	0	738078	0	0
729	739083	0	1005	0	739083	0	0
730	740087	0	1004	0	740087	0	0
731	741093	0	1006	0	741093	0	0
732	742096	0	1003	0	742096	0	0
733	743100	0	1004	0	743100	0	0
734	744104	0	1004	0	744104	0	0
735	745109	0	1005	0	745109	0	0
736	746113	0	1004	0	746113	0	0
737	747121	0	1008	0	747121	0	0
738	748127	0	1006	0	748127	0	0
739	749132	0	1005	0	749132	0	0
740	750137	0	1005	0	750137	0	0
741	751142	0	1005	0	751142	0	0
742	752146	0	1004	0	752146	0	0
743	753151	0	1005	0	753151	0	0
744	754155	0	1004	0	754155	0	0
745	755158	0	1003	0	755158	0	0
746	756161	0	1003	0	756161	0	0
747	757166	0	1005	0	757166	0	0
748	758171	0	1005	0	758171	0	0
749	759176	0	1005	0	759176	0	0
750	760180	0	1004	0	760180	0	0
751	761185	0	1005	0	761185	0	0
752	762189	0	1004	0	762189	0	0
753	763193	0	1004	0	763193	0	0
754	764197	0	1004	0	764197	0	0
755	765200	0	1003	0	765200	0	0
756	766205	0	1005	0	766205	0	0
757	767209	0	1004	0	767209	0	0
758	768214	0	1005	0	768214	0	0
759	769218	0	1004	0	769218	0	0
760	770223	0	1005	0	770223	0	0
761	771228	0	1005	0	771228	0	0
762	772233	0	1005	0	772233	0	0
763	773237	0	1004	0	773237	0	0
764	774242	0	1005	0	774242	0	0
765	775247	0	1005	0	775247	0	0
766	776250	0	1003	0	776250	0	0
767	777254	0	1004	0	777254	0	0
768	778259	0	1005	0	778259	0	0
769	779263	0	1004	0	779263	0	0
770	780266	0	1003	0	780266	0	0
771	781270	0	1004	0	781270	0	0
772	782275	0	1005	0	782275	0	0
773	783279	0	1004	0	783279	0	0
774	784283	0	1004	0	784283	0	0
775	785287	0	1004	0	785287	0	0
776	786292	0	1005	0	786292	0	0
777	787296	0	1004	0	787296	0	0
778	788301	0	1005	0	788301	0	0
779	789305	0	1004	0	789305	0	0
780	790309	0	1004	0	790309	0	0
781	791312	0	1003	0	791312	0	0
782	792317	0	1005	0	792317	0	0
783	793322	0	1005	0	793322	0	0
784	794326	0	1004	0	794326	0	0
785	795330	0	1004	0	795330	0	0
786	796334	0	1004	0	796334	0	0
787	797338	0	1004	0	797338	0	0
788	798343	0	1005	0	798343	0	0
789	799349	0	1006	0	799349	0	0
790	800353	0	1004	0	800353	0	0
791	801358	0	1005	0	801358	0	0
792	802361	0	1003	0	802361	0	0
793	803365	0	1004	0	803365	0	0
794	804371	0	1006	0	804371	0	0
795	805374	0	1003	0	805374	0	0
796	806379	0	1005	0	806379	0	0
797	807384	0	1005	0	807384	0	0
798	808388	0	1004	0	808388	0	0
799	809391	0	1003	0	809391	0	0
800	810396	0	1005	0	810396	0	0
801	811401	0	1005	0	811401	0	0
802	812405	0	1004	0	812405	0	0
803	813410	0	1005	0	813410	0	0
804	814414	0	1004	0	814414	0	0
805	815418	0	1004	0	815418	0	0
806	816423	0	1005	0	816423	0	0
807	817429	0	1006	0	817429	0	0
808	818433	0	1004	0	818433	0	0
809	819438	0	1005	0	819438	0	0
810	820442	0	1004	0	820442	0	0
811	821447	0	1005	0	821447	0	0
812	822452	0	1005	0	822452	0	0
813	823456	0	1004	0	823456	0	0
814	824459	0	1003	0	824459	0	0
815	825462	0	1003	0	825462	0	0
816	826467	0	1005	0	826467	0	0
817	827472	0	1005	0	827472	0	0
818	828477	0	1005	0	828477	0	0
819	829481	0	1004	0	829481	0	0
820	830486	0	1005	0	830486	0	0
821	831490	0	1004	0	831490	0	0
822	832494	0	1004	0	832494	0	0
823	833497	0	1003	0	833497	0	0
824	834501	0	1004	0	834501	0	0
825	835505	0	1004	0	835505	0	0
826	836510	0	1005	0	836510	0	0
827	837514	0	1004	0	837514	0	0
828	838518	0	1004	0	838518	0	0
829	839523	0	1005	0	839523	0	0
830	840528	0	1005	0	840528	0	0
831	841532	0	1004	0	841532	0	0
832	842536	0	1004	0	842536	0	0
833	843540	0	1004	0	843540	0	0
834	844543	0	1003	0	844543	0	0
835	845548	0	1005	0	845548	0	0
836	846552	0	1004	0	846552	0	0
837	847557	0	1005	0	847557	0	0
838	848562	0	1005	0	848562	0	0
839	849567	0	1005	0	849567	0	0
840	850571	0	1004	0	850571	0	0
841	851575	0	1004	0	851575	0	0
842	852578	0	1003	0	852578	0	0
843	853582	0	1004	0	853582	0	0
844	854587	0	1005	0	854587	0	0
845	855592	0	1005	0	855592	0	0
846	856595	0	1003	0	856595	0	0
847	857600	0	1005	0	857600	0	0
848	858605	0	1005	0	858605	0	0
849	859609	0	1004	0	859609	0	0
850	860614	0	1005	0	860614	0	0
851	861617	0	1003	0	861617	0	0
852	862622	0	1005	0	862622	0	0
853	863626	0	1004	0	863626	0	0
854	864631	0	1005	0	864631	0	0
855	865636	0	1005	0	865636	0	0
856	866641	0	1005	0	866641	0	0
857	867644	0	1003	0	867644	0	0
858	868649	0	1005	0	868649	0	0
859	869654	0	1005	0	869654	0	0
860	870658	0	1004	0	870658	0	0
861	871663	0	1005	0	871663	0	0
862	872667	0	1004	0	872667	0	0
863	873671	0	1004	0	873671	0	0
864	874676	0	1005	0	874676	0	0
865	875681	0	1005	0	875681	0	0
866	876686	0	1005	0	876686	0	0
867	877691	0	1005	0	877691	0	0
868	878695	0	1004	0	878695	0	0
869	879699	0	1004	0	879699	0	0
870	880702	0	1003	0	880702	0	0
871	881706	0	1004	0	881706	0	0
872	882709	0	1003	0	882709	0	0
873	883714	0	1005	0	883714	0	0
874	884718	0	1004	0	884718	0	0
875	885723	0	1005	0	885723	0	0
876	886727	0	1004	0	886727	0	0
877	887730	0	1003	0	887730	0	0
878	888735	0	1005	0	888735	0	0
879	889739	0	1004	0	889739	0	0
880	890744	0	1005	0	890744	0	0
881	891749	0	1005	0	891749	0	0
882	892753	0	1004	0	892753	0	0
883	893757	0	1004	0	893757	0	0
884	894760	0	1003	0	894760	0	0
885	895765	0	1005	0	895765	0	0
886	896770	0	1005	0	896770	0	0
887	897774	0	1004	0	897774	0	0
888	898779	0	1005	0	898779	0	0
889	899784	0	1005	0	899784	0	0
890	900788	0	1004	0	900788	0	0
891	901793	0	1005	0	901793	0	0
892	902798	0	1005	0	902798	0	0
893	903802	0	1004	0	903802	0	0
894	904807	0	1005	0	904807	0	0
895	905811	0	1004	0	905811	0	0
896	906816	0	1005	0	906816	0	0
897	907821	0	1005	0	907821	0	0
898	908825	0	1004	0	908825	0	0
899	909830	0	1005	0	909830	0	0
900	910835	0	1005	0	910835	0	0
901	911839	0	1004	0	911839	0	0
902	912843	0	1004	0	912843	0	0
903	913846	0	1003	0	913846	0	0
904	914851	0	1005	0	914851	0	0
905	915855	0	1004	0	915855	0	0
906	916860	0	1005	0	916860	0	0
907	917875	0	1015	0	917875	0	0
908	918891	0	1016	0	918891	0	0
909	919896	0	1005	0	919896	0	0
910	920901	0	1005	0	920901	0	0
911	921905	0	1004	0	921905	0	0
912	922908	0	1003	0	922908	0	0
913	923912	0	1004	0	923912	0	0
914	924916	0	1004	0	924916	0	0
915	925921	0	1005	0	925921	0	0
916	926924	0	1003	0	926924	0	0
917	927928	0	1004	0	927928	0	0
918	928933	0	1005	0	928933	0	0
919	929937	0	1004	0	929937	0	0
920	930942	0	1005	0	930942	0	0
921	931945	0	1003	0	931945	0	0
922	932949	0	1004	0	932949	0	0
923	933954	0	1005	0	933954	0	0
924	934959	0	1005	0	934959	0	0
925	935962	0	1003	0	935962	0	0
926	936967	0	1005	0	936967	0	0
927	937972	0	1005	0	937972	0	0
928	938977	0	1005	0	938977	0	0
929	939982	0	1005	0	939982	0	0
930	940986	0	1004	0	940986	0	0
931	941991	0	1005	0	941991	0	0
932	942996	0	1005	0	942996	0	0
933	944000	0	1004	0	944000	0	0
934	945005	0	1005	0	945005	0	0
935	946009	0	1004	0	946009	0	0
936	947013	0	1004	0	947013	0	0
937	948018	0	1005	0	948018	0	0
938	949023	0	1005	0	949023	0	0
939	950028	0	1005	0	950028	0	0
940	951033	0	1005	0	951033	0	0
941	952037	0	1004	0	952037	0	0
942	953042	0	1005	0	953042	0	0
943	954046	0	1004	0	954046	0	0
944	955050	0	1004	0	955050	0	0
945	956053	0	1003	0	956053	0	0
946	957058	0	1005	0	957058	0	0
947	958061	0	1003	0	958061	0	0
948	959065	0	1004	0	959065	0	0
949	960070	0	1005	0	960070	0	0
950	961074	0	1004	0	961074	0	0
951	962078	0	1004	0	962078	0	0
952	963083	0	1005	0	963083	0	0
953	964088	0	1005	0	964088	0	0
954	965093	0	1005	0	965093	0	0
955	966097	0	1004	0	966097	0	0
956	967102	0	1005	0	967102	0	0
957	968106	0	1004	0	968106	0	0
958	969111	0	1005	0	969111	0	0
959	970119	0	1008	0	970119	0	0
960	971124	0	1005	0	971124	0	0
961	972130	0	1006	0	972130	0	0
962	973135	0	1005	0	973135	0	0
963	974139	0	1004	0	974139	0	0
964	975143	0	1004	0	975143	0	0
965	976148	0	1005	0	976148	0	0
966	977152	0	1004	0	977152	0	0
967	978158	0	1006	0	978158	0	0
968	979162	0	1004	0	979162	0	0
969	980167	0	1005	0	980167	0	0
970	981171	0	1004	0	981171	0	0
971	982175	0	1004	0	982175	0	0
972	983179	0	1004	0	983179	0	0
973	984184	0	1005	0	984184	0	0
974	985188	0	1004	0	985188	0	0
975	986192	0	1004	0	986192	0	0
976	987197	0	1005	0	987197	0	0
977	988201	0	1004	0	988201	0	0
978	989205	0	1004	0	989205	0	0
979	990208	0	1003	0	990208	0	0
980	991212	0	1004	0	991212	0	0
981	992217	0	1005	0	992217	0	0
982	993222	0	1005	0	993222	0	0
983	994227	0	1005	0	994227	0	0
984	995232	0	1005	0	995232	0	0
985	996236	0	1004	0	996236	0	0
986	997239	0	1003	0	997239	0	0
987	998243	0	1004	0	998243	0	0
988	999247	0	1004	0	999247	0	0
989	1000250	0	1003	0	1000250	0	0
990	1001254	0	1004	0	1001254	0	0
991	1002259	0	1005	0	1002259	0	0
992	1003263	0	1004	0	1003263	0	0
993	1004268	0	1005	0	1004268	0	0
994	1005273	0	1005	0	1005273	0	0
995	1006277	0	1004	0	1006277	0	0
996	1007284	0	1007	0	1007284	0	0
997	1008288	0	1004	0	1008288	0	0
998	1009291	0	1003	0	1009291	0	0
999	1010295	0	1004	0	1010295	0	0
1000	1011299	0	1004	0	1011299	0	0
1001	1012304	0	1005	0	1012304	0	0
1002	1013309	0	1005	0	1013309	0	0
1003	1014314	0	1005	0	1014314	0	0
1004	1015319	0	1005	0	1015319	0	0
1005	1016322	0	1003	0	1016322	0	0
1006	1017327	0	1005	0	1017327	0	0
1007	1018331	0	1004	0	1018331	0	0
1008	1019336	0	1005	0	1019336	0	0
1009	1020341	0	1005	0	1020341	0	0
1010	1021345	0	1004	0	1021345	0	0
1011	1022349	0	1004	0	1022349	0	0
1012	1023354	0	1005	0	1023354	0	0
1013	1024357	0	1003	0	1024357	0	0
1014	1025363	0	1006	0	1025363	0	0
1015	1026369	0	1006	0	1026369	0	0
1016	1027373	0	1004	0	1027373	0	0
1017	1028378	0	1005	0	1028378	0	0
1018	1029382	0	1004	0	1029382	0	0
1019	1030386	0	1004	0	1030386	0	0
1020	1031391	0	1005	0	1031391	0	0
1021	1032394	0	1003	0	1032394	0	0
1022	1033398	0	1004	0	1033398	0	0
1023	1034403	0	1005	0	1034403	0	0
1024	1035407	0	1004	0	1035407	0	0
1025	1036412	0	1005	0	1036412	0	0
1026	1037417	0	1005	0	1037417	0	0
1027	1038422	0	1005	0	1038422	0	0
1028	1039427	0	1005	0	1039427	0	0
1029	1040431	0	1004	0	1040431	0	0
1030	1041435	0	1004	0	1041435	0	0
1031	1042439	0	1004	0	1042439	0	0
1032	1043443	0	1004	0	1043443	0	0
1033	1044447	0	1004	0	1044447	0	0
1034	1045452	0	1005	0	1045452	0	0
1035	1046457	0	1005	0	1046457	0	0
1036	1047461	0	1004	0	1047461	0	0
1037	1048465	0	1004	0	1048465	0	0
1038	1049469	0	1004	0	1049469	0	0
1039	1050474	0	1005	0	1050474	0	0
1040	1051479	0	1005	0	1051479	0	0
1041	1052483	0	1004	0	1052483	0	0
1042	1053488	0	1005	0	1053488	0	0
1043	1054493	0	1005	0	1054493	0	0
1044	1055497	0	1004	0	1055497	0	0
1045	1056502	0	1005	0	1056502	0	0
1046	1057507	0	1005	0	1057507	0	0
1047	1058512	0	1005	0	1058512	0	0
1048	1059516	0	1004	0	1059516	0	0
1049	1060521	0	1005	0	1060521	0	0
1050	1061526	0	1005	0	1061526	0	0
1051	1062530	0	1004	0	1062530	0	0
1052	1063534	0	1004	0	1063534	0	0
1053	1064538	0	1004	0	1064538	0	0
1054	1065543	0	1005	0	1065543	0	0
1055	1066546	0	1003	0	1066546	0	0
1056	1067549	0	1003	0	1067549	0	0
1057	1068552	0	1003	0	1068552	0	0
1058	1069555	0	1003	0	1069555	0	0
1059	1070558	0	1003	0	1070558	0	0
1060	1071563	0	1005	0	1071563	0	0
1061	1072568	0	1005	0	1072568	0	0
1062	1073573	0	1005	0	1073573	0	0
1063	1074578	0	1005	0	1074578	0	0
1064	1075583	0	1005	0	1075583	0	0
1065	1076588	0	1005	0	1076588	0	0
1066	1077592	0	1004	0	1077592	0	0
1067	1078597	0	1005	0	1078597	0	0
1068	1079601	0	1004	0	1079601	0	0
1069	1080606	0	1005	0	1080606	0	0
1070	1081609	0	1003	0	1081609	0	0
1071	1082613	0	1004	0	1082613	0	0
1072	1083616	0	1003	0	1083616	0	0
1073	1084620	0	1004	0	1084620	0	0
1074	1085624	0	1004	0	1085624	0	0
1075	1086629	0	1005	0	1086629	0	0
1076	1087633	0	1004	0	1087633	0	0
1077	1088636	0	1003	0	1088636	0	0
1078	1089641	0	1005	0	1089641	0	0
1079	1090644	0	1003	0	1090644	0	0
1080	1091647	0	1003	0	1091647	0	0
1081	1092652	0	1005	0	1092652	0	0
1082	1093657	0	1005	0	1093657	0	0
1083	1094660	0	1003	0	1094660	0	0
1084	1095663	0	1003	0	1095663	0	0
1085	1096666	0	1003	0	1096666	0	0
1086	1097670	0	1004	0	1097670	0	0
1087	1098675	0	1005	0	1098675	0	0
1088	1099678	0	1003	0	1099678	0	0
1089	1100682	0	1004	0	1100682	0	0
1090	1101687	0	1005	0	1101687	0	0
1091	1102692	0	1005	0	1102692	0	0
1092	1103697	0	1005	0	1103697	0	0
1093	1104701	0	1004	0	1104701	0	0
1094	1105706	0	1005	0	1105706	0	0
1095	1106710	0	1004	0	1106710	0	0
1096	1107714	0	1004	0	1107714	0	0
1097	1108719	0	1005	0	1108719	0	0
1098	1109724	0	1005	0	1109724	0	0
1099	1110728	0	1004	0	1110728	0	0
1100	1111733	0	1005	0	1111733	0	0
1101	1112738	0	1005	0	1112738	0	0
1102	1113742	0	1004	0	1113742	0	0
1103	1114749	0	1007	0	1114749	0	0
1104	1115753	0	1004	0	1115753	0	0
1105	1116758	0	1005	0	1116758	0	0
1106	1117761	0	1003	0	1117761	0	0
1107	1118766	0	1005	0	1118766	0	0
1108	1119770	0	1004	0	1119770	0	0
1109	1120774	0	1004	0	1120774	0	0
1110	1121779	0	1005	0	1121779	0	0
1111	1122784	0	1005	0	1122784	0	0
1112	1123788	0	1004	0	1123788	0	0
1113	1124792	0	1004	0	1124792	0	0
1114	1125798	0	1006	0	1125798	0	0
1115	1126802	0	1004	0	1126802	0	0
1116	1127806	0	1004	0	1127806	0	0
1117	1128812	0	1006	0	1128812	0	0
1118	1129816	0	1004	0	1129816	0	0
1119	1130819	0	1003	0	1130819	0	0
1120	1131823	0	1004	0	1131823	0	0
1121	1132827	0	1004	0	1132827	0	0
1122	1133831	0	1004	0	1133831	0	0
1123	1134835	0	1004	0	1134835	0	0
1124	1135840	0	1005	0	1135840	0	0
1125	1136844	0	1004	0	1136844	0	0
1126	1137848	0	1004	0	1137848	0	0
1127	1138852	0	1004	0	1138852	0	0
1128	1139856	0	1004	0	1139856	0	0
1129	1140871	0	1015	0	1140871	0	0
1130	1141874	0	1003	0	1141874	0	0
1131	1142879	0	1005	0	1142879	0	0
1132	1143884	0	1005	0	1143884	0	0
1133	1144889	0	1005	0	1144889	0	0
1134	1145893	0	1004	0	1145893	0	0
1135	1146897	0	1004	0	1146897	0	0
1136	1147901	0	1004	0	1147901	0	0
1137	1148906	0	1005	0	1148906	0	0
1138	1149909	0	1003	0	1149909	0	0
1139	1150912	0	1003	0	1150912	0	0
1140	1151916	0	1004	0	1151916	0	0
1141	1152921	0	1005	0	1152921	0	0
1142	1153926	0	1005	0	1153926	0	0
1143	1154930	0	1004	0	1154930	0	0
1144	1155934	0	1004	0	1155934	0	0
1145	1156939	0	1005	0	1156939	0	0
1146	1157944	0	1005	0	1157944	0	0
1147	1158949	0	1005	0	1158949	0	0
1148	1159953	0	1004	0	1159953	0	0
1149	1160957	0	1004	0	1160957	0	0
1150	1161962	0	1005	0	1161962	0	0
1151	1162966	0	1004	0	1162966	0	0
1152	1163969	0	1003	0	1163969	0	0
1153	1164975	0	1006	0	1164975	0	0
1154	1165980	0	1005	0	1165980	0	0
1155	1166984	0	1004	0	1166984	0	0
1156	1167988	0	1004	0	1167988	0	0
1157	1168994	0	1006	0	1168994	0	0
1158	1169999	0	1005	0	1169999	0	0
1159	1171003	0	1004	0	1171003	0	0
1160	1172008	0	1005	0	1172008	0	0
1161	1173013	0	1005	0	1173013	0	0
1162	1174017	0	1004	0	1174017	0	0
1163	1175022	0	1005	0	1175022	0	0
1164	1176027	0	1005	0	1176027	0	0
1165	1177031	0	1004	0	1177031	0	0
1166	1178036	0	1005	0	1178036	0	0
1167	1179041	0	1005	0	1179041	0	0
1168	1180045	0	1004	0	1180045	0	0
1169	1181050	0	1005	0	1181050	0	0
1170	1182055	0	1005	0	1182055	0	0
1171	1183061	0	1006	0	1183061	0	0
1172	1184065	0	1004	0	1184065	0	0
1173	1185070	0	1005	0	1185070	0	0
1174	1186075	0	1005	0	1186075	0	0
1175	1187079	0	1004	0	1187079	0	0
1176	1188084	0	1005	0	1188084	0	0
1177	1189088	0	1004	0	1189088	0	0
1178	1190093	0	1005	0	1190093	0	0
1179	1191098	0	1005	0	1191098	0	0
1180	1192102	0	1004	0	1192102	0	0
1181	1193106	0	1004	0	1193106	0	0
1182	1194111	0	1005	0	1194111	0	0
1183	1195118	0	1007	0	1195118	0	0
1184	1196121	0	1003	0	1196121	0	0
1185	1197128	0	1007	0	1197128	0	0
1186	1198133	0	1005	0	1198133	0	0
1187	1199138	0	1005	0	1199138	0	0
1188	1200143	0	1005	0	1200143	0	0
1189	1201147	0	1004	0	1201147	0	0
1190	1202151	0	1004	0	1202151	0	0
1191	1203156	0	1005	0	1203156	0	0
1192	1204160	0	1004	0	1204160	0	0
1193	1205164	0	1004	0	1205164	0	0
1194	1206169	0	1005	0	1206169	0	0
1195	1207173	0	1004	0	1207173	0	0
1196	1208177	0	1004	0	1208177	0	0
1197	1209181	0	1004	0	1209181	0	0
1198	1210186	0	1005	0	1210186	0	0
1199	1211190	0	1004	0	1211190	0	0
1200	1212195	0	1005	0	1212195	0	0
1201	1213199	0	1004	0	1213199	0	0
1202	1214204	0	1005	0	1214204	0	0
1203	1215208	0	1004	0	1215208	0	0
1204	1216213	0	1005	0	1216213	0	0
1205	1217218	0	1005	0	1217218	0	0
1206	1218223	0	1005	0	1218223	0	0
1207	1219227	0	1004	0	1219227	0	0
1208	1220232	0	1005	0	1220232	0	0
1209	1221236	0	1004	0	1221236	0	0
1210	1222242	0	1006	0	1222242	0	0
1211	1223246	0	1004	0	1223246	0	0
1212	1224250	0	1004	0	1224250	0	0
1213	1225254	0	1004	0	1225254	0	0
1214	1226258	0	1004	0	1226258	0	0
1215	1227263	0	1005	0	1227263	0	0
1216	1228268	0	1005	0	1228268	0	0
1217	1229273	0	1005	0	1229273	0	0
1218	1230276	0	1003	0	1230276	0	0
1219	1231281	0	1005	0	1231281	0	0
1220	1232284	0	1003	0	1232284	0	0
1221	1233290	0	1006	0	1233290	0	0
1222	1234295	0	1005	0	1234295	0	0
1223	1235300	0	1005	0	1235300	0	0
1224	1236305	0	1005	0	1236305	0	0
1225	1237310	0	1005	0	1237310	0	0
1226	1238314	0	1004	0	1238314	0	0
1227	1239318	0	1004	0	1239318	0	0
1228	1240322	0	1004	0	1240322	0	0
1229	1241326	0	1004	0	1241326	0	0
1230	1242330	0	1004	0	1242330	0	0
1231	1243334	0	1004	0	1243334	0	0
1232	1244339	0	1005	0	1244339	0	0
1233	1245342	0	1003	0	1245342	0	0
1234	1246346	0	1004	0	1246346	0	0
1235	1247350	0	1004	0	1247350	0	0
1236	1248354	0	1004	0	1248354	0	0
1237	1249358	0	1004	0	1249358	0	0
1238	1250363	0	1005	0	1250363	0	0
1239	1251368	0	1005	0	1251368	0	0
1240	1252372	0	1004	0	1252372	0	0
1241	1253376	0	1004	0	1253376	0	0
1242	1254380	0	1004	0	1254380	0	0
1243	1255385	0	1005	0	1255385	0	0
1244	1256390	0	1005	0	1256390	0	0
1245	1257396	0	1006	0	1257396	0	0
1246	1258400	0	1004	0	1258400	0	0
1247	1259404	0	1004	0	1259404	0	0
1248	1260409	0	1005	0	1260409	0	0
1249	1261414	0	1005	0	1261414	0	0
1250	1262418	0	1004	0	1262418	0	0
1251	1263422	0	1004	0	1263422	0	0
1252	1264427	0	1005	0	1264427	0	0
1253	1265430	0	1003	0	1265430	0	0
1254	1266435	0	1005	0	1266435	0	0
1255	1267438	0	1003	0	1267438	0	0
1256	1268441	0	1003	0	1268441	0	0
1257	1269445	0	1004	0	1269445	0	0
1258	1270450	0	1005	0	1270450	0	0
1259	1271454	0	1004	0	1271454	0	0
1260	1272457	0	1003	0	1272457	0	0
1261	1273462	0	1005	0	1273462	0	0
1262	1274467	0	1005	0	1274467	0	0
1263	1275471	0	1004	0	1275471	0	0
1264	1276475	0	1004	0	1276475	0	0
1265	1277478	0	1003	0	1277478	0	0
1266	1278482	0	1004	0	1278482	0	0
1267	1279486	0	1004	0	1279486	0	0
1268	1280490	0	1004	0	1280490	0	0
1269	1281495	0	1005	0	1281495	0	0
1270	1282499	0	1004	0	1282499	0	0
1271	1283504	0	1005	0	1283504	0	0
1272	1284509	0	1005	0	1284509	0	0
1273	1285513	0	1004	0	1285513	0	0
1274	1286518	0	1005	0	1286518	0	0
1275	1287522	0	1004	0	1287522	0	0
1276	1288527	0	1005	0	1288527	0	0
1277	1289532	0	1005	0	1289532	0	0
1278	1290536	0	1004	0	1290536	0	0
1279	1291541	0	1005	0	1291541	0	0
1280	1292546	0	1005	0	1292546	0	0
1281	1293550	0	1004	0	1293550	0	0
1282	1294555	0	1005	0	1294555	0	0
1283	1295560	0	1005	0	1295560	0	0
1284	1296565	0	1005	0	1296565	0	0
1285	1297569	0	1004	0	1297569	0	0
1286	1298574	0	1005	0	1298574	0	0
1287	1299578	0	1004	0	1299578	0	0
1288	1300583	0	1005	0	1300583	0	0
1289	1301588	0	1005	0	1301588	0	0
1290	1302592	0	1004	0	1302592	0	0
1291	1303597	0	1005	0	1303597	0	0
1292	1304601	0	1004	0	1304601	0	0
1293	1305606	0	1005	0	1305606	0	0
1294	1306611	0	1005	0	1306611	0	0
1295	1307616	0	1005	0	1307616	0	0
1296	1308620	0	1004	0	1308620	0	0
1297	1309625	0	1005	0	1309625	0	0
1298	1310629	0	1004	0	1310629	0	0
1299	1311634	0	1005	0	1311634	0	0
1300	1312637	0	1003	0	1312637	0	0
1301	1313642	0	1005	0	1313642	0	0
1302	1314647	0	1005	0	1314647	0	0
1303	1315650	0	1003	0	1315650	0	0
1304	1316655	0	1005	0	1316655	0	0
1305	1317660	0	1005	0	1317660	0	0
1306	1318664	0	1004	0	1318664	0	0
1307	1319669	0	1005	0	1319669	0	0
1308	1320674	0	1005	0	1320674	0	0
1309	1321678	0	1004	0	1321678	0	0
1310	1322683	0	1005	0	1322683	0	0
1311	1323687	0	1004	0	1323687	0	0
1312	1324692	0	1005	0	1324692	0	0
1313	1325697	0	1005	0	1325697	0	0
1314	1326702	0	1005	0	1326702	0	0
1315	1327706	0	1004	0	1327706	0	0
1316	1328711	0	1005	0	1328711	0	0
1317	1329715	0	1004	0	1329715	0	0
1318	1330720	0	1005	0	1330720	0	0
1319	1331725	0	1005	0	1331725	0	0
1320	1332729	0	1004	0	1332729	0	0
1321	1333733	0	1004	0	1333733	0	0
1322	1334739	0	1006	0	1334739	0	0
1323	1335742	0	1003	0	1335742	0	0
1324	1336745	0	1003	0	1336745	0	0
1325	1337750	0	1005	0	1337750	0	0
1326	1338755	0	1005	0	1338755	0	0
1327	1339759	0	1004	0	1339759	0	0
1328	1340764	0	1005	0	1340764	0	0
1329	1341769	0	1005	0	1341769	0	0
1330	1342773	0	1004	0	1342773	0	0
1331	1343778	0	1005	0	1343778	0	0
1332	1344783	0	1005	0	1344783	0	0
1333	1345787	0	1004	0	1345787	0	0
1334	1346792	0	1005	0	1346792	0	0
1335	1347797	0	1005	0	1347797	0	0
1336	1348801	0	1004	0	1348801	0	0
1337	1349806	0	1005	0	1349806	0	0
1338	1350810	0	1004	0	1350810	0	0
1339	1351815	0	1005	0	1351815	0	0
1340	1352819	0	1004	0	1352819	0	0
1341	1353824	0	1005	0	1353824	0	0
1342	1354829	0	1005	0	1354829	0	0
1343	1355834	0	1005	0	1355834	0	0
1344	1356838	0	1004	0	1356838	0	0
1345	1357842	0	1004	0	1357842	0	0
1346	1358847	0	1005	0	1358847	0	0
1347	1359852	0	1005	0	1359852	0	0
1348	1360857	0	1005	0	1360857	0	0
1349	1361860	0	1003	0	1361860	0	0
1350	1362875	0	1015	0	1362875	0	0
1351	1363880	0	1005	0	1363880	0	0
1352	1364885	0	1005	0	1364885	0	0
1353	1365889	0	1004	0	1365889	0	0
1354	1366894	0	1005	0	1366894	0	0
1355	1367899	0	1005	0	1367899	0	0
1356	1368903	0	1004	0	1368903	0	0
1357	1369908	0	1005	0	1369908	0	0
1358	1370912	0	1004	0	1370912	0	0
1359	1371916	0	1004	0	1371916	0	0
1360	1372920	0	1004	0	1372920	0	0
1361	1373925	0	1005	0	1373925	0	0
1362	1374930	0	1005	0	1374930	0	0
1363	1375935	0	1005	0	1375935	0	0
1364	1376939	0	1004	0	1376939	0	0
1365	1377943	0	1004	0	1377943	0	0
1366	1378948	0	1005	0	1378948	0	0
1367	1379953	0	1005	0	1379953	0	0
1368	1380957	0	1004	0	1380957	0	0
1369	1381960	0	1003	0	1381960	0	0
1370	1382965	0	1005	0	1382965	0	0
1371	1383970	0	1005	0	1383970	0	0
1372	1384974	0	1004	0	1384974	0	0
1373	1385978	0	1004	0	1385978	0	0
1374	1386982	0	1004	0	1386982	0	0
1375	1387987	0	1005	0	1387987	0	0
1376	1388992	0	1005	0	1388992	0	0
1377	1389996	0	1004	0	1389996	0	0
1378	1391000	0	1004	0	1391000	0	0
1379	1392005	0	1005	0	1392005	0	0
1380	1393010	0	1005	0	1393010	0	0
1381	1394015	0	1005	0	1394015	0	0
1382	1395020	0	1005	0	1395020	0	0
1383	1396024	0	1004	0	1396024	0	0
1384	1397029	0	1005	0	1397029	0	0
1385	1398034	0	1005	0	1398034	0	0
1386	1399039	0	1005	0	1399039	0	0
1387	1400044	0	1005	0	1400044	0	0
1388	1401048	0	1004	0	1401048	0	0
1389	1402053	0	1005	0	1402053	0	0
1390	1403058	0	1005	0	1403058	0	0
1391	1404062	0	1004	0	1404062	0	0
1392	1405067	0	1005	0	1405067	0	0
1393	1406073	0	1006	0	1406073	0	0
1394	1407078	0	1005	0	1407078	0	0
1395	1408082	0	1004	0	1408082	0	0
1396	1409087	0	1005	0	1409087	0	0
1397	1410091	0	1004	0	1410091	0	0
1398	1411096	0	1005	0	1411096	0	0
1399	1412101	0	1005	0	1412101	0	0
1400	1413105	0	1004	0	1413105	0	0
1401	1414110	0	1005	0	1414110	0	0
1402	1415119	0	1009	0	1415119	0	0
1403	1416125	0	1006	0	1416125	0	0
1404	1417130	0	1005	0	1417130	0	0
1405	1418135	0	1005	0	1418135	0	0
1406	1419141	0	1006	0	1419141	0	0
1407	1420146	0	1005	0	1420146	0	0
1408	1421150	0	1004	0	1421150	0	0
1409	1422156	0	1006	0	1422156	0	0
1410	1423160	0	1004	0	1423160	0	0
1411	1424165	0	1005	0	1424165	0	0
1412	1425170	0	1005	0	1425170	0	0
1413	1426175	0	1005	0	1426175	0	0
1414	1427180	0	1005	0	1427180	0	0
1415	1428185	0	1005	0	1428185	0	0
1416	1429188	0	1003	0	1429188	0	0
1417	1430192	0	1004	0	1430192	0	0
1418	1431197	0	1005	0	1431197	0	0
1419	1432202	0	1005	0	1432202	0	0
1420	1433205	0	1003	0	1433205	0	0
1421	1434209	0	1004	0	1434209	0	0
1422	1435214	0	1005	0	1435214	0	0
1423	1436219	0	1005	0	1436219	0	0
1424	1437223	0	1004	0	1437223	0	0
1425	1438227	0	1004	0	1438227	0	0
1426	1439231	0	1004	0	1439231	0	0
1427	1440235	0	1004	0	1440235	0	0
1428	1441240	0	1005	0	1441240	0	0
1429	1442243	0	1003	0	1442243	0	0
1430	1443248	0	1005	0	1443248	0	0
1431	1444251	0	1003	0	1444251	0	0
1432	1445256	0	1005	0	1445256	0	0
1433	1446261	0	1005	0	1446261	0	0
1434	1447266	0	1005	0	1447266	0	0
1435	1448271	0	1005	0	1448271	0	0
1436	1449275	0	1004	0	1449275	0	0
1437	1450280	0	1005	0	1450280	0	0
1438	1451285	0	1005	0	1451285	0	0
1439	1452289	0	1004	0	1452289	0	0
1440	1453294	0	1005	0	1453294	0	0
1441	1454298	0	1004	0	1454298	0	0
1442	1455301	0	1003	0	1455301	0	0
1443	1456305	0	1004	0	1456305	0	0
1444	1457311	0	1006	0	1457311	0	0
1445	1458315	0	1004	0	1458315	0	0
1446	1459321	0	1006	0	1459321	0	0
1447	1460326	0	1005	0	1460326	0	0
1448	1461330	0	1004	0	1461330	0	0
1449	1462336	0	1006	0	1462336	0	0
1450	1463340	0	1004	0	1463340	0	0
1451	1464344	0	1004	0	1464344	0	0
1452	1465349	0	1005	0	1465349	0	0
1453	1466355	0	1006	0	1466355	0	0
1454	1467361	0	1006	0	1467361	0	0
1455	1468365	0	1004	0	1468365	0	0
1456	1469370	0	1005	0	1469370	0	0
1457	1470374	0	1004	0	1470374	0	0
1458	1471379	0	1005	0	1471379	0	0
1459	1472384	0	1005	0	1472384	0	0
1460	1473388	0	1004	0	1473388	0	0
1461	1474393	0	1005	0	1474393	0	0
1462	1475397	0	1004	0	1475397	0	0
1463	1476402	0	1005	0	1476402	0	0
1464	1477407	0	1005	0	1477407	0	0
1465	1478411	0	1004	0	1478411	0	0
1466	1479416	0	1005	0	1479416	0	0
1467	1480421	0	1005	0	1480421	0	0
1468	1481425	0	1004	0	1481425	0	0
1469	1482430	0	1005	0	1482430	0	0
1470	1483435	0	1005	0	1483435	0	0
1471	1484440	0	1005	0	1484440	0	0
1472	1485443	0	1003	0	1485443	0	0
1473	1486447	0	1004	0	1486447	0	0
1474	1487450	0	1003	0	1487450	0	0
1475	1488453	0	1003	0	1488453	0	0
1476	1489457	0	1004	0	1489457	0	0
1477	1490462	0	1005	0	1490462	0	0
1478	1491467	0	1005	0	1491467	0	0
1479	1492472	0	1005	0	1492472	0	0
1480	1493477	0	1005	0	1493477	0	0
1481	1494481	0	1004	0	1494481	0	0
1482	1495486	0	1005	0	1495486	0	0
1483	1496491	0	1005	0	1496491	0	0
1484	1497495	0	1004	0	1497495	0	0
1485	1498500	0	1005	0	1498500	0	0
1486	1499504	0	1004	0	1499504	0	0
1487	1500509	0	1005	0	1500509	0	0
1488	1501514	0	1005	0	1501514	0	0
1489	1502519	0	1005	0	1502519	0	0
1490	1503523	0	1004	0	1503523	0	0
1491	1504528	0	1005	0	1504528	0	0
1492	1505533	0	1005	0	1505533	0	0
1493	1506536	0	1003	0	1506536	0	0
1494	1507903	0	1367	0	1507903	0	0
1495	1508907	0	1004	0	1508907	0	0
1496	1509911	0	1004	0	1509911	0	0
1497	1510916	0	1005	0	1510916	0	0
1498	1512087	0	1171	0	1512087	0	0
1499	1513091	0	1004	0	1513091	0	0
1500	1514095	0	1004	0	1514095	0	0
1501	1515099	0	1004	0	1515099	0	0
1502	1516104	0	1005	0	1516104	0	0
1503	1517110	0	1006	0	1517110	0	0
1504	1518117	0	1007	0	1518117	0	0
1505	1519122	0	1005	0	1519122	0	0
1506	1520127	0	1005	0	1520127	0	0
1507	1521132	0	1005	0	1521132	0	0
1508	1522135	0	1003	0	1522135	0	0
1509	1523141	0	1006	0	1523141	0	0
1510	1524147	0	1006	0	1524147	0	0
1511	1525152	0	1005	0	1525152	0	0
1512	1526157	0	1005	0	1526157	0	0
1513	1527161	0	1004	0	1527161	0	0
1514	1528166	0	1005	0	1528166	0	0
1515	1529171	0	1005	0	1529171	0	0
1516	1530176	0	1005	0	1530176	0	0
1517	1531180	0	1004	0	1531180	0	0
1518	1532185	0	1005	0	1532185	0	0
1519	1533190	0	1005	0	1533190	0	0
1520	1534194	0	1004	0	1534194	0	0
1521	1535198	0	1004	0	1535198	0	0
1522	1536203	0	1005	0	1536203	0	0
1523	1537208	0	1005	0	1537208	0	0
1524	1538213	0	1005	0	1538213	0	0
1525	1539218	0	1005	0	1539218	0	0
1526	1540223	0	1005	0	1540223	0	0
1527	1541227	0	1004	0	1541227	0	0
1528	1542231	0	1004	0	1542231	0	0
1529	1543236	0	1005	0	1543236	0	0
1530	1544241	0	1005	0	1544241	0	0
1531	1545246	0	1005	0	1545246	0	0
1532	1546250	0	1004	0	1546250	0	0
1533	1547254	0	1004	0	1547254	0	0
1534	1548259	0	1005	0	1548259	0	0
1535	1549264	0	1005	0	1549264	0	0
1536	1550268	0	1004	0	1550268	0	0
1537	1551272	0	1004	0	1551272	0	0
1538	1552275	0	1003	0	1552275	0	0
1539	1553280	0	1005	0	1553280	0	0
1540	1554284	0	1004	0	1554284	0	0
1541	1555288	0	1004	0	1555288	0	0
1542	1556292	0	1004	0	1556292	0	0
1543	1557296	0	1004	0	1557296	0	0
1544	1558300	0	1004	0	1558300	0	0
1545	1559304	0	1004	0	1559304	0	0
1546	1560308	0	1004	0	1560308	0	0
1547	1561312	0	1004	0	1561312	0	0
1548	1562317	0	1005	0	1562317	0	0
1549	1563322	0	1005	0	1563322	0	0
1550	1564326	0	1004	0	1564326	0	0
1551	1565331	0	1005	0	1565331	0	0
1552	1566335	0	1004	0	1566335	0	0
1553	1567340	0	1005	0	1567340	0	0
1554	1568345	0	1005	0	1568345	0	0
1555	1569351	0	1006	0	1569351	0	0
1556	1570356	0	1005	0	1570356	0	0
1557	1571360	0	1004	0	1571360	0	0
1558	1572364	0	1004	0	1572364	0	0
1559	1573368	0	1004	0	1573368	0	0
1560	1574371	0	1003	0	1574371	0	0
1561	1575376	0	1005	0	1575376	0	0
1562	1576380	0	1004	0	1576380	0	0
1563	1577384	0	1004	0	1577384	0	0
1564	1578387	0	1003	0	1578387	0	0
1565	1579392	0	1005	0	1579392	0	0
1566	1580397	0	1005	0	1580397	0	0
1567	1581402	0	1005	0	1581402	0	0
1568	1582406	0	1004	0	1582406	0	0
1569	1583412	0	1006	0	1583412	0	0
1570	1584415	0	1003	0	1584415	0	0
1571	1585419	0	1004	0	1585419	0	0
1572	1586423	0	1004	0	1586423	0	0
1573	1587427	0	1004	0	1587427	0	0
1574	1588432	0	1005	0	1588432	0	0
1575	1589436	0	1004	0	1589436	0	0
1576	1590441	0	1005	0	1590441	0	0
1577	1591445	0	1004	0	1591445	0	0
1578	1592449	0	1004	0	1592449	0	0
1579	1593452	0	1003	0	1593452	0	0
1580	1594457	0	1005	0	1594457	0	0
1581	1595461	0	1004	0	1595461	0	0
1582	1596466	0	1005	0	1596466	0	0
1583	1597469	0	1003	0	1597469	0	0
1584	1598473	0	1004	0	1598473	0	0
1585	1599476	0	1003	0	1599476	0	0
1586	1600480	0	1004	0	1600480	0	0
1587	1601484	0	1004	0	1601484	0	0
1588	1602487	0	1003	0	1602487	0	0
1589	1603492	0	1005	0	1603492	0	0
1590	1604497	0	1005	0	1604497	0	0
1591	1605502	0	1005	0	1605502	0	0
1592	1606506	0	1004	0	1606506	0	0
1593	1607511	0	1005	0	1607511	0	0
1594	1608515	0	1004	0	1608515	0	0
1595	1609520	0	1005	0	1609520	0	0
1596	1610525	0	1005	0	1610525	0	0
1597	1611530	0	1005	0	1611530	0	0
1598	1612535	0	1005	0	1612535	0	0
1599	1613540	0	1005	0	1613540	0	0
1600	1614545	0	1005	0	1614545	0	0
1601	1615550	0	1005	0	1615550	0	0
1602	1616554	0	1004	0	1616554	0	0
1603	1617559	0	1005	0	1617559	0	0
1604	1618564	0	1005	0	1618564	0	0
1605	1619569	0	1005	0	1619569	0	0
1606	1620573	0	1004	0	1620573	0	0
1607	1621576	0	1003	0	1621576	0	0
1608	1622579	0	1003	0	1622579	0	0
1609	1623582	0	1003	0	1623582	0	0
1610	1624587	0	1005	0	1624587	0	0
1611	1625591	0	1004	0	1625591	0	0
1612	1626596	0	1005	0	1626596	0	0
1613	1627601	0	1005	0	1627601	0	0
1614	1628606	0	1005	0	1628606	0	0
1615	1629610	0	1004	0	1629610	0	0
1616	1630614	0	1004	0	1630614	0	0
1617	1631619	0	1005	0	1631619	0	0
1618	1632625	0	1006	0	1632625	0	0
1619	1633628	0	1003	0	1633628	0	0
1620	1634631	0	1003	0	1634631	0	0
1621	1635636	0	1005	0	1635636	0	0
1622	1636639	0	1003	0	1636639	0	0
1623	1637643	0	1004	0	1637643	0	0
1624	1638648	0	1005	0	1638648	0	0
1625	1639652	0	1004	0	1639652	0	0
1626	1640656	0	1004	0	1640656	0	0
1627	1641659	0	1003	0	1641659	0	0
1628	1642664	0	1005	0	1642664	0	0
1629	1643668	0	1004	0	1643668	0	0
1630	1644672	0	1004	0	1644672	0	0
1631	1645678	0	1006	0	1645678	0	0
1632	1646682	0	1004	0	1646682	0	0
1633	1647687	0	1005	0	1647687	0	0
1634	1648691	0	1004	0	1648691	0	0
1635	1649696	0	1005	0	1649696	0	0
1636	1650701	0	1005	0	1650701	0	0
1637	1651706	0	1005	0	1651706	0	0
1638	1652711	0	1005	0	1652711	0	0
1639	1653714	0	1003	0	1653714	0	0
1640	1654720	0	1006	0	1654720	0	0
1641	1655724	0	1004	0	1655724	0	0
1642	1656728	0	1004	0	1656728	0	0
1643	1657733	0	1005	0	1657733	0	0
1644	1658738	0	1005	0	1658738	0	0
1645	1659743	0	1005	0	1659743	0	0
1646	1660747	0	1004	0	1660747	0	0
1647	1661752	0	1005	0	1661752	0	0
1648	1662757	0	1005	0	1662757	0	0
1649	1663761	0	1004	0	1663761	0	0
1650	1664766	0	1005	0	1664766	0	0
1651	1665771	0	1005	0	1665771	0	0
1652	1666775	0	1004	0	1666775	0	0
1653	1667828	0	1053	0	1667828	0	0
1654	1668832	0	1004	0	1668832	0	0
1655	1669836	0	1004	0	1669836	0	0
1656	1670840	0	1004	0	1670840	0	0
1657	1671845	0	1005	0	1671845	0	0
1658	1672850	0	1005	0	1672850	0	0
1659	1673854	0	1004	0	1673854	0	0
1660	1674858	0	1004	0	1674858	0	0
1661	1675872	0	1014	0	1675872	0	0
1662	1676875	0	1003	0	1676875	0	0
1663	1677880	0	1005	0	1677880	0	0
1664	1678891	0	1011	0	1678891	0	0
1665	1679896	0	1005	0	1679896	0	0
1666	1680901	0	1005	0	1680901	0	0
1667	1681905	0	1004	0	1681905	0	0
1668	1682910	0	1005	0	1682910	0	0
1669	1683914	0	1004	0	1683914	0	0
1670	1684919	0	1005	0	1684919	0	0
1671	1685924	0	1005	0	1685924	0	0
1672	1686928	0	1004	0	1686928	0	0
1673	1687933	0	1005	0	1687933	0	0
1674	1688938	0	1005	0	1688938	0	0
1675	1689942	0	1004	0	1689942	0	0
1676	1690947	0	1005	0	1690947	0	0
1677	1691952	0	1005	0	1691952	0	0
1678	1692956	0	1004	0	1692956	0	0
1679	1693961	0	1005	0	1693961	0	0
1680	1694965	0	1004	0	1694965	0	0
1681	1695970	0	1005	0	1695970	0	0
1682	1696975	0	1005	0	1696975	0	0
1683	1697979	0	1004	0	1697979	0	0
1684	1698984	0	1005	0	1698984	0	0
1685	1699989	0	1005	0	1699989	0	0
1686	1700993	0	1004	0	1700993	0	0
1687	1701998	0	1005	0	1701998	0	0
1688	1703003	0	1005	0	1703003	0	0
1689	1704007	0	1004	0	1704007	0	0
1690	1705012	0	1005	0	1705012	0	0
1691	1706015	0	1003	0	1706015	0	0
1692	1707020	0	1005	0	1707020	0	0
1693	1708024	0	1004	0	1708024	0	0
1694	1709027	0	1003	0	1709027	0	0
1695	1710032	0	1005	0	1710032	0	0
1696	1711038	0	1006	0	1711038	0	0
1697	1712042	0	1004	0	1712042	0	0
1698	1713046	0	1004	0	1713046	0	0
1699	1714050	0	1004	0	1714050	0	0
1700	1715055	0	1005	0	1715055	0	0
1701	1716060	0	1005	0	1716060	0	0
1702	1717065	0	1005	0	1717065	0	0
1703	1718068	0	1003	0	1718068	0	0
1704	1719073	0	1005	0	1719073	0	0
1705	1720077	0	1004	0	1720077	0	0
1706	1721081	0	1004	0	1721081	0	0
1707	1722087	0	1006	0	1722087	0	0
1708	1723092	0	1005	0	1723092	0	0
1709	1724096	0	1004	0	1724096	0	0
1710	1725100	0	1004	0	1725100	0	0
1711	1726105	0	1005	0	1726105	0	0
1712	1727109	0	1004	0	1727109	0	0
1713	1728113	0	1004	0	1728113	0	0
1714	1729119	0	1006	0	1729119	0	0
1715	1730125	0	1006	0	1730125	0	0
1716	1731130	0	1005	0	1731130	0	0
1717	1732135	0	1005	0	1732135	0	0
1718	1733141	0	1006	0	1733141	0	0
1719	1734145	0	1004	0	1734145	0	0
1720	1735149	0	1004	0	1735149	0	0
1721	1736155	0	1006	0	1736155	0	0
1722	1737159	0	1004	0	1737159	0	0
1723	1738164	0	1005	0	1738164	0	0
1724	1739168	0	1004	0	1739168	0	0
1725	1740172	0	1004	0	1740172	0	0
1726	1741177	0	1005	0	1741177	0	0
1727	1742180	0	1003	0	1742180	0	0
1728	1743185	0	1005	0	1743185	0	0
1729	1744189	0	1004	0	1744189	0	0
1730	1745192	0	1003	0	1745192	0	0
1731	1746196	0	1004	0	1746196	0	0
1732	1747201	0	1005	0	1747201	0	0
1733	1748206	0	1005	0	1748206	0	0
1734	1749211	0	1005	0	1749211	0	0
1735	1750216	0	1005	0	1750216	0	0
1736	1751221	0	1005	0	1751221	0	0
1737	1752225	0	1004	0	1752225	0	0
1738	1753231	0	1006	0	1753231	0	0
1739	1754235	0	1004	0	1754235	0	0
1740	1755240	0	1005	0	1755240	0	0
1741	1756244	0	1004	0	1756244	0	0
1742	1757249	0	1005	0	1757249	0	0
1743	1758254	0	1005	0	1758254	0	0
1744	1759258	0	1004	0	1759258	0	0
1745	1760263	0	1005	0	1760263	0	0
1746	1761268	0	1005	0	1761268	0	0
1747	1762272	0	1004	0	1762272	0	0
1748	1763276	0	1004	0	1763276	0	0
1749	1764280	0	1004	0	1764280	0	0
1750	1765285	0	1005	0	1765285	0	0
1751	1766290	0	1005	0	1766290	0	0
1752	1767295	0	1005	0	1767295	0	0
1753	1768300	0	1005	0	1768300	0	0
1754	1769305	0	1005	0	1769305	0	0
1755	1770309	0	1004	0	1770309	0	0
1756	1771313	0	1004	0	1771313	0	0
1757	1772318	0	1005	0	1772318	0	0
1758	1773323	0	1005	0	1773323	0	0
1759	1774328	0	1005	0	1774328	0	0
1760	1775332	0	1004	0	1775332	0	0
1761	1776337	0	1005	0	1776337	0	0
1762	1777341	0	1004	0	1777341	0	0
1763	1778346	0	1005	0	1778346	0	0
1764	1779352	0	1006	0	1779352	0	0
1765	1780355	0	1003	0	1780355	0	0
1766	1781360	0	1005	0	1781360	0	0
1767	1782366	0	1006	0	1782366	0	0
1768	1783370	0	1004	0	1783370	0	0
1769	1784374	0	1004	0	1784374	0	0
1770	1785379	0	1005	0	1785379	0	0
1771	1786384	0	1005	0	1786384	0	0
1772	1787389	0	1005	0	1787389	0	0
1773	1788394	0	1005	0	1788394	0	0
1774	1789398	0	1004	0	1789398	0	0
1775	1790402	0	1004	0	1790402	0	0
1776	1791406	0	1004	0	1791406	0	0
1777	1792410	0	1004	0	1792410	0	0
1778	1793414	0	1004	0	1793414	0	0
1779	1794419	0	1005	0	1794419	0	0
1780	1795424	0	1005	0	1795424	0	0
1781	1796429	0	1005	0	1796429	0	0
1782	1797433	0	1004	0	1797433	0	0
1783	1798436	0	1003	0	1798436	0	0
1784	1799441	0	1005	0	1799441	0	0
1785	1800445	0	1004	0	1800445	0	0
1786	1801448	0	1003	0	1801448	0	0
1787	1802453	0	1005	0	1802453	0	0
1788	1803457	0	1004	0	1803457	0	0
1789	1804462	0	1005	0	1804462	0	0
1790	1805467	0	1005	0	1805467	0	0
1791	1806471	0	1004	0	1806471	0	0
1792	1807476	0	1005	0	1807476	0	0
1793	1808479	0	1003	0	1808479	0	0
1794	1809483	0	1004	0	1809483	0	0
1795	1810488	0	1005	0	1810488	0	0
1796	1811492	0	1004	0	1811492	0	0
1797	1812497	0	1005	0	1812497	0	0
1798	1813502	0	1005	0	1813502	0	0
1799	1814506	0	1004	0	1814506	0	0
1800	1815511	0	1005	0	1815511	0	0
1801	1816516	0	1005	0	1816516	0	0
1802	1817520	0	1004	0	1817520	0	0
1803	1818525	0	1005	0	1818525	0	0
1804	1819529	0	1004	0	1819529	0	0
1805	1820534	0	1005	0	1820534	0	0
1806	1821539	0	1005	0	1821539	0	0
1807	1822544	0	1005	0	1822544	0	0
1808	1823549	0	1005	0	1823549	0	0
1809	1824552	0	1003	0	1824552	0	0
1810	1825557	0	1005	0	1825557	0	0
1811	1826561	0	1004	0	1826561	0	0
1812	1827565	0	1004	0	1827565	0	0
1813	1828569	0	1004	0	1828569	0	0
1814	1829573	0	1004	0	1829573	0	0
1815	1830578	0	1005	0	1830578	0	0
1816	1831583	0	1005	0	1831583	0	0
1817	1832588	0	1005	0	1832588	0	0
1818	1833592	0	1004	0	1833592	0	0
1819	1834597	0	1005	0	1834597	0	0
1820	1835602	0	1005	0	1835602	0	0
1821	1836607	0	1005	0	1836607	0	0
1822	1837611	0	1004	0	1837611	0	0
1823	1838616	0	1005	0	1838616	0	0
1824	1839621	0	1005	0	1839621	0	0
1825	1840625	0	1004	0	1840625	0	0
1826	1841630	0	1005	0	1841630	0	0
1827	1842634	0	1004	0	1842634	0	0
1828	1843638	0	1004	0	1843638	0	0
1829	1844642	0	1004	0	1844642	0	0
1830	1845647	0	1005	0	1845647	0	0
1831	1846651	0	1004	0	1846651	0	0
1832	1847655	0	1004	0	1847655	0	0
1833	1848659	0	1004	0	1848659	0	0
1834	1849664	0	1005	0	1849664	0	0
1835	1850668	0	1004	0	1850668	0	0
1836	1851673	0	1005	0	1851673	0	0
1837	1852678	0	1005	0	1852678	0	0
1838	1853682	0	1004	0	1853682	0	0
1839	1854686	0	1004	0	1854686	0	0
1840	1855691	0	1005	0	1855691	0	0
1841	1856695	0	1004	0	1856695	0	0
1842	1857698	0	1003	0	1857698	0	0
1843	1858703	0	1005	0	1858703	0	0
1844	1859706	0	1003	0	1859706	0	0
1845	1860710	0	1004	0	1860710	0	0
1846	1861714	0	1004	0	1861714	0	0
1847	1862718	0	1004	0	1862718	0	0
1848	1863723	0	1005	0	1863723	0	0
1849	1864726	0	1003	0	1864726	0	0
1850	1865730	0	1004	0	1865730	0	0
1851	1866734	0	1004	0	1866734	0	0
1852	1867738	0	1004	0	1867738	0	0
1853	1868742	0	1004	0	1868742	0	0
1854	1869746	0	1004	0	1869746	0	0
1855	1870751	0	1005	0	1870751	0	0
1856	1871755	0	1004	0	1871755	0	0
1857	1872759	0	1004	0	1872759	0	0
1858	1873762	0	1003	0	1873762	0	0
1859	1874767	0	1005	0	1874767	0	0
1860	1875770	0	1003	0	1875770	0	0
1861	1876774	0	1004	0	1876774	0	0
1862	1877777	0	1003	0	1877777	0	0
1863	1878780	0	1003	0	1878780	0	0
1864	1879785	0	1005	0	1879785	0	0
1865	1880790	0	1005	0	1880790	0	0
1866	1881794	0	1004	0	1881794	0	0
1867	1882799	0	1005	0	1882799	0	0
1868	1883803	0	1004	0	1883803	0	0
1869	1884808	0	1005	0	1884808	0	0
1870	1885813	0	1005	0	1885813	0	0
1871	1886817	0	1004	0	1886817	0	0
1872	1887822	0	1005	0	1887822	0	0
1873	1888827	0	1005	0	1888827	0	0
1874	1889831	0	1004	0	1889831	0	0
1875	1890836	0	1005	0	1890836	0	0
1876	1891841	0	1005	0	1891841	0	0
1877	1892845	0	1004	0	1892845	0	0
1878	1893850	0	1005	0	1893850	0	0
1879	1894854	0	1004	0	1894854	0	0
1880	1895859	0	1005	0	1895859	0	0
1881	1896872	0	1013	0	1896872	0	0
1882	1897875	0	1003	0	1897875	0	0
1883	1898889	0	1014	0	1898889	0	0
1884	1899894	0	1005	0	1899894	0	0
1885	1900898	0	1004	0	1900898	0	0
1886	1901902	0	1004	0	1901902	0	0
1887	1902906	0	1004	0	1902906	0	0
1888	1903910	0	1004	0	1903910	0	0
1889	1904915	0	1005	0	1904915	0	0
1890	1906038	0	1123	0	1906038	0	0
1891	1907043	0	1005	0	1907043	1	1
1892	1908048	0	1005	0	1908048	0	1
1893	1909053	0	1005	0	1909053	0	1
1894	1910058	0	1005	0	1910058	0	1
1895	1911063	0	1005	0	1911063	0	1
1896	1912068	0	1005	0	1912068	0	1
1897	1913072	0	1004	0	1913072	0	1
1898	1914077	0	1005	0	1914077	0	1
1899	1915082	0	1005	0	1915082	0	1
1900	1916087	0	1005	0	1916087	0	1
1901	1917090	0	1003	0	1917090	0	1
1902	1918095	0	1005	0	1918095	0	1
1903	1919100	0	1005	0	1919100	0	1
1904	1920104	0	1004	0	1920104	0	1
1905	1921107	0	1003	0	1921107	0	1
1906	1922110	0	1003	0	1922110	0	1
1907	1923119	0	1009	0	1923119	0	1
1908	1924124	0	1005	0	1924124	0	1
1909	1925129	0	1005	0	1925129	0	1
1910	1926133	0	1004	0	1926133	0	1
1911	1927139	0	1006	0	1927139	0	1
1912	1928143	0	1004	0	1928143	0	1
1913	1929149	0	1006	0	1929149	0	1
1914	1930155	0	1006	0	1930155	0	1
1915	1931160	0	1005	0	1931160	0	1
1916	1932165	0	1005	0	1932165	0	1
1917	1933170	0	1005	0	1933170	0	1
1918	1934175	0	1005	0	1934175	0	1
1919	1935181	0	1006	0	1935181	0	1
1920	1936186	0	1005	0	1936186	0	1
1921	1937190	0	1004	0	1937190	0	1
1922	1938194	0	1004	0	1938194	0	1
1923	1939200	0	1006	0	1939200	0	1
1924	1940205	0	1005	0	1940205	0	1
1925	1941210	0	1005	0	1941210	0	1
1926	1942214	0	1004	0	1942214	0	1
1927	1943218	0	1004	0	1943218	0	1
1928	1944222	0	1004	0	1944222	0	1
1929	1945225	0	1003	0	1945225	0	1
1930	1946230	0	1005	0	1946230	0	1
1931	1947235	0	1005	0	1947235	0	1
1932	1948240	0	1005	0	1948240	0	1
1933	1949243	0	1003	0	1949243	0	1
1934	1950246	0	1003	0	1950246	0	1
1935	1951250	0	1004	0	1951250	0	1
1936	1952253	0	1003	0	1952253	0	1
1937	1953256	0	1003	0	1953256	0	1
1938	1954260	0	1004	0	1954260	0	1
1939	1955264	0	1004	0	1955264	0	1
1940	1956269	0	1005	0	1956269	0	1
1941	1957274	0	1005	0	1957274	0	1
1942	1958279	0	1005	0	1958279	0	1
1943	1959284	0	1005	0	1959284	0	1
1944	1960287	0	1003	0	1960287	0	1
1945	1961290	0	1003	0	1961290	0	1
1946	1962294	0	1004	0	1962294	0	1
1947	1963298	0	1004	0	1963298	0	1
1948	1964302	0	1004	0	1964302	0	1
1949	1965305	0	1003	0	1965305	0	1
1950	1966310	0	1005	0	1966310	0	1
1951	1967315	0	1005	0	1967315	0	1
1952	1968318	0	1003	0	1968318	0	1
1953	1969321	0	1003	0	1969321	0	1
1954	1970325	0	1004	0	1970325	0	1
1955	1971329	0	1004	0	1971329	0	1
1956	1972334	0	1005	0	1972334	0	1
1957	1973339	0	1005	0	1973339	0	1
1958	1974344	0	1005	0	1974344	0	1
1959	1975348	0	1004	0	1975348	0	1
1960	1976353	0	1005	0	1976353	0	1
1961	1977357	0	1004	0	1977357	0	1
1962	1978362	0	1005	0	1978362	0	1
1963	1979367	0	1005	0	1979367	0	1
1964	1980371	0	1004	0	1980371	0	1
1965	1981375	0	1004	0	1981375	0	1
1966	1982379	0	1004	0	1982379	0	1
1967	1983384	0	1005	0	1983384	0	1
1968	1984388	0	1004	0	1984388	0	1
1969	1985392	0	1004	0	1985392	0	1
1970	1986397	0	1005	0	1986397	0	1
1971	1987401	0	1004	0	1987401	0	1
1972	1988405	0	1004	0	1988405	0	1
1973	1989409	0	1004	0	1989409	0	1
1974	1990414	0	1005	0	1990414	0	1
1975	1991417	0	1003	0	1991417	0	1
1976	1992421	0	1004	0	1992421	0	1
1977	1993426	0	1005	0	1993426	0	1
1978	1994431	0	1005	0	1994431	0	1
1979	1995437	0	1006	0	1995437	0	1
1980	1996443	0	1006	0	1996443	0	1
1981	1997448	0	1005	0	1997448	0	1
1982	1998452	0	1004	0	1998452	0	1
1983	1999457	0	1005	0	1999457	0	1
1984	2000461	0	1004	0	2000461	0	1
1985	2001466	0	1005	0	2001466	0	1
1986	2002471	0	1005	0	2002471	0	1
1987	2003476	0	1005	0	2003476	0	1
1988	2004480	0	1004	0	2004480	0	1
1989	2005485	0	1005	0	2005485	0	1
1990	2006490	0	1005	0	2006490	0	1
1991	2007494	0	1004	0	2007494	0	1
1992	2008498	0	1004	0	2008498	0	1
1993	2009502	0	1004	0	2009502	0	1
1994	2010507	0	1005	0	2010507	0	1
1995	2011511	0	1004	0	2011511	0	1
1996	2012515	0	1004	0	2012515	0	1
1997	2013520	0	1005	0	2013520	0	1
1998	2014524	0	1004	0	2014524	0	1
1999	2015528	0	1004	0	2015528	0	1
2000	2016532	0	1004	0	2016532	0	1
2001	2017537	0	1005	0	2017537	0	1
2002	2018541	0	1004	0	2018541	0	1
2003	2019545	0	1004	0	2019545	0	1
2004	2020548	0	1003	0	2020548	0	1
2005	2021553	0	1005	0	2021553	0	1
2006	2022557	0	1004	0	2022557	0	1
2007	2023562	0	1005	0	2023562	0	1
2008	2024565	0	1003	0	2024565	0	1
2009	2025569	0	1004	0	2025569	0	1
2010	2026573	0	1004	0	2026573	0	1
2011	2027581	0	1008	0	2027581	0	1
2012	2028586	0	1005	0	2028586	0	1
2013	2029590	0	1004	0	2029590	0	1
2014	2030595	0	1005	0	2030595	0	1
2015	2031600	0	1005	0	2031600	0	1
2016	2032604	0	1004	0	2032604	0	1
2017	2033609	0	1005	0	2033609	0	1
2018	2034613	0	1004	0	2034613	0	1
2019	2035617	0	1004	0	2035617	0	1
2020	2036620	0	1003	0	2036620	0	1
2021	2037623	0	1003	0	2037623	0	1
2022	2038627	0	1004	0	2038627	0	1
2023	2039631	0	1004	0	2039631	0	1
2024	2040635	0	1004	0	2040635	0	1
2025	2041639	0	1004	0	2041639	0	1
2026	2042644	0	1005	0	2042644	0	1
2027	2043648	0	1004	0	2043648	0	1
2028	2044654	0	1006	0	2044654	0	1
2029	2045657	0	1003	0	2045657	0	1
2030	2046661	0	1004	0	2046661	0	1
2031	2047664	0	1003	0	2047664	0	1
2032	2048669	0	1005	0	2048669	0	1
2033	2049674	0	1005	0	2049674	0	1
2034	2050679	0	1005	0	2050679	0	1
2035	2051683	0	1004	0	2051683	0	1
2036	2052687	0	1004	0	2052687	0	1
2037	2053692	0	1005	0	2053692	0	1
2038	2054699	0	1007	0	2054699	0	1
2039	2055702	0	1003	0	2055702	0	1
2040	2056706	0	1004	0	2056706	0	1
2041	2057711	0	1005	0	2057711	0	1
2042	2058715	0	1004	0	2058715	0	1
2043	2059720	0	1005	0	2059720	0	1
2044	2060725	0	1005	0	2060725	0	1
2045	2061730	0	1005	0	2061730	0	1
2046	2062733	0	1003	0	2062733	0	1
2047	2063738	0	1005	0	2063738	0	1
2048	2064743	0	1005	0	2064743	0	1
2049	2065748	0	1005	0	2065748	0	1
2050	2066752	0	1004	0	2066752	0	1
2051	2067757	0	1005	0	2067757	0	1
2052	2068762	0	1005	0	2068762	0	1
2053	2069767	0	1005	0	2069767	0	1
2054	2070771	0	1004	0	2070771	0	1
2055	2071776	0	1005	0	2071776	0	1
2056	2072780	0	1004	0	2072780	0	1
2057	2073785	0	1005	0	2073785	0	1
2058	2074789	0	1004	0	2074789	0	1
2059	2075794	0	1005	0	2075794	0	1
2060	2076798	0	1004	0	2076798	0	1
2061	2077802	0	1004	0	2077802	0	1
2062	2078806	0	1004	0	2078806	0	1
2063	2079809	0	1003	0	2079809	0	1
2064	2080812	0	1003	0	2080812	0	1
2065	2081817	0	1005	0	2081817	0	1
2066	2082822	0	1005	0	2082822	0	1
2067	2083826	0	1004	0	2083826	0	1
2068	2084830	0	1004	0	2084830	0	1
2069	2085835	0	1005	0	2085835	0	1
2070	2086838	0	1003	0	2086838	0	1
2071	2087842	0	1004	0	2087842	0	1
2072	2088846	0	1004	0	2088846	0	1
2073	2089849	0	1003	0	2089849	0	1
2074	2090854	0	1005	0	2090854	0	1
2075	2091858	0	1004	0	2091858	0	1
2076	2092872	0	1014	0	2092872	0	1
2077	2093878	0	1006	0	2093878	0	1
2078	2094883	0	1005	0	2094883	0	1
2079	2095888	0	1005	0	2095888	0	1
2080	2096891	94305	1003	94305	2002586	1	1
2081	2097896	94305	1005	0	2003591	0	1
2082	2098900	94305	1004	0	2004595	0	1
2083	2099905	94305	1005	0	2005600	0	1
2084	2100910	94305	1005	0	2006605	0	1
2085	2101915	94305	1005	0	2007610	0	1
2086	2102919	94305	1004	0	2008614	0	1
2087	2103924	94305	1005	0	2009619	0	1
2088	2104928	94305	1004	0	2010623	0	1
2089	2105933	94305	1005	0	2011628	0	1
2090	2106938	94305	1005	0	2012633	0	1
2091	2107942	94305	1004	0	2013637	0	1
2092	2108947	94305	1005	0	2014642	0	1
2093	2109951	94305	1004	0	2015646	0	1
2094	2110955	94305	1004	0	2016650	0	1
2095	2111960	94305	1005	0	2017655	0	1
2096	2112964	94305	1004	0	2018659	0	1
2097	2113979	94305	1015	0	2019674	0	1
2098	2114983	94305	1004	0	2020678	0	1
2099	2116034	94305	1051	0	2021729	0	1
2100	2117039	114108	1005	19803	2002931	1	1
2101	2118044	114108	1005	0	2003936	0	1
2102	2119048	114108	1004	0	2004940	0	1
2103	2120052	114108	1004	0	2005944	0	1
2104	2121056	114108	1004	0	2006948	0	1
2105	2122061	114108	1005	0	2007953	0	1
2106	2123065	114108	1004	0	2008957	0	1
2107	2124070	114108	1005	0	2009962	0	1
2108	2125074	114108	1004	0	2010966	0	1
2109	2126078	114108	1004	0	2011970	0	1
2110	2127082	114108	1004	0	2012974	0	1
2111	2128086	114108	1004	0	2013978	0	1
2112	2129090	114108	1004	0	2014982	0	1
2113	2130095	114108	1005	0	2015987	0	1
2114	2131098	114108	1003	0	2016990	0	1
2115	2132101	114108	1003	0	2017993	0	1
2116	2133105	114108	1004	0	2018997	0	1
2117	2134109	114108	1004	0	2020001	0	1
2118	2135112	114108	1003	0	2021004	0	1
2119	2136119	114108	1007	0	2022011	0	1
2120	2137125	114108	1006	0	2023017	0	1
2121	2138130	114108	1005	0	2024022	0	1
2122	2139136	114108	1006	0	2025028	0	1
2123	2140141	114108	1005	0	2026033	0	1
2124	2141145	114108	1004	0	2027037	0	1
2125	2142150	114108	1005	0	2028042	0	1
2126	2143157	114108	1007	0	2029049	0	1
2127	2144160	114108	1003	0	2030052	0	1
2128	2145164	114108	1004	0	2031056	0	1
2129	2146169	114108	1005	0	2032061	0	1
2130	2147174	114108	1005	0	2033066	0	1
2131	2148178	114108	1004	0	2034070	0	1
2132	2149183	114108	1005	0	2035075	0	1
2133	2150188	114108	1005	0	2036080	0	1
2134	2151191	114108	1003	0	2037083	0	1
2135	2152196	114108	1005	0	2038088	0	1
2136	2153201	114108	1005	0	2039093	0	1
2137	2154206	114108	1005	0	2040098	0	1
2138	2155210	114108	1004	0	2041102	0	1
2139	2156244	154012	1034	39904	2002232	1	1
2140	2157248	154012	1004	0	2003236	0	1
2141	2158253	154012	1005	0	2004241	0	1
2142	2159257	154012	1004	0	2005245	0	1
2143	2160261	154012	1004	0	2006249	0	1
2144	2161265	154012	1004	0	2007253	0	1
2145	2162269	154012	1004	0	2008257	0	1
2146	2163274	154012	1005	0	2009262	0	1
2147	2164278	154012	1004	0	2010266	0	1
2148	2165283	154012	1005	0	2011271	0	1
2149	2166287	154012	1004	0	2012275	0	1
2150	2167292	154012	1005	0	2013280	0	1
2151	2168296	154012	1004	0	2014284	0	1
2152	2169300	154012	1004	0	2015288	0	1
2153	2170305	154012	1005	0	2016293	0	1
2154	2171310	154012	1005	0	2017298	0	1
2155	2172315	154012	1005	0	2018303	0	1
2156	2173319	154012	1004	0	2019307	0	1
2157	2174324	154012	1005	0	2020312	0	1
2158	2175328	154012	1004	0	2021316	0	1
2159	2176333	154012	1005	0	2022321	0	1
2160	2177338	154012	1005	0	2023326	0	1
2161	2178615	154012	1277	0	2024603	0	1
2162	2179620	154012	1005	0	2025608	0	1
2163	2180625	154012	1005	0	2026613	0	1
2164	2181630	154012	1005	0	2027618	0	1
2165	2182634	154012	1004	0	2028622	0	1
2166	2183637	154012	1003	0	2029625	0	1
2167	2184641	154012	1004	0	2030629	0	1
2168	2185646	154012	1005	0	2031634	0	1
2169	2186651	154012	1005	0	2032639	0	1
2170	2187656	154012	1005	0	2033644	0	1
2171	2188660	154012	1004	0	2034648	0	1
2172	2189664	154012	1004	0	2035652	0	1
2173	2190669	154012	1005	0	2036657	0	1
2174	2191674	154012	1005	0	2037662	0	1
2175	2192677	154012	1003	0	2038665	0	1
2176	2193681	154012	1004	0	2039669	0	1
2177	2194686	154012	1005	0	2040674	0	1
2178	2195690	154012	1004	0	2041678	0	1
2179	2196694	154012	1004	0	2042682	0	1
2180	2197700	154012	1006	0	2043688	0	1
2181	2198706	154012	1006	0	2044694	0	1
2182	2199713	154012	1007	0	2045701	0	1
2183	2200717	154012	1004	0	2046705	0	1
2184	2201722	154012	1005	0	2047710	0	1
2185	2202727	154012	1005	0	2048715	0	1
2186	2203731	154012	1004	0	2049719	0	1
2187	2204735	154012	1004	0	2050723	0	1
2188	2205739	154012	1004	0	2051727	0	1
2189	2206743	154012	1004	0	2052731	0	1
2190	2207746	154012	1003	0	2053734	0	1
2191	2208749	154012	1003	0	2054737	0	1
2192	2209753	154012	1004	0	2055741	0	1
2193	2210757	154012	1004	0	2056745	0	1
2194	2211762	154012	1005	0	2057750	0	1
2195	2212766	154012	1004	0	2058754	0	1
2196	2213771	154012	1005	0	2059759	0	1
2197	2214775	154012	1004	0	2060763	0	1
2198	2215780	154012	1005	0	2061768	0	1
2199	2216784	154012	1004	0	2062772	0	1
2200	2217789	154012	1005	0	2063777	0	1
2201	2218794	154012	1005	0	2064782	0	1
2202	2219798	154012	1004	0	2065786	0	1
2203	2220803	154012	1005	0	2066791	0	1
2204	2221807	154012	1004	0	2067795	0	1
2205	2222810	154012	1003	0	2068798	0	1
2206	2223814	154012	1004	0	2069802	0	1
2207	2224819	154012	1005	0	2070807	0	1
2208	2225823	154012	1004	0	2071811	0	1
2209	2226828	154012	1005	0	2072816	0	1
2210	2227831	154012	1003	0	2073819	0	1
2211	2228835	154012	1004	0	2074823	0	1
2212	2229840	154012	1005	0	2075828	0	1
2213	2230845	154012	1005	0	2076833	0	1
2214	2231849	154012	1004	0	2077837	0	1
2215	2232854	154012	1005	0	2078842	0	1
2216	2233858	154012	1004	0	2079846	0	1
2217	2234872	154012	1014	0	2080860	0	1
2218	2235910	154012	1038	0	2081898	0	1
2219	2236916	234389	1006	80377	2002527	1	1
2220	2237919	234389	1003	0	2003530	0	1
2221	2238924	234389	1005	0	2004535	0	1
2222	2239929	234389	1005	0	2005540	0	1
2223	2240934	234389	1005	0	2006545	0	1
2224	2241938	234389	1004	0	2007549	0	1
2225	2242941	234389	1003	0	2008552	0	1
2226	2243945	234389	1004	0	2009556	0	1
2227	2244950	234389	1005	0	2010561	0	1
2228	2245955	234389	1005	0	2011566	0	1
2229	2246960	234389	1005	0	2012571	0	1
2230	2247964	234389	1004	0	2013575	0	1
2231	2248969	234389	1005	0	2014580	0	1
2232	2249974	234389	1005	0	2015585	0	1
2233	2250979	234389	1005	0	2016590	0	1
2234	2251982	234389	1003	0	2017593	0	1
2235	2252986	234389	1004	0	2018597	0	1
2236	2253990	234389	1004	0	2019601	0	1
2237	2254994	234389	1004	0	2020605	0	1
2238	2255999	234389	1005	0	2021610	0	1
2239	2257002	234389	1003	0	2022613	0	1
2240	2258007	234389	1005	0	2023618	0	1
2241	2259011	234389	1004	0	2024622	0	1
2242	2260014	234389	1003	0	2025625	0	1
2243	2261018	234389	1004	0	2026629	0	1
2244	2262022	234389	1004	0	2027633	0	1
2245	2263026	234389	1004	0	2028637	0	1
2246	2264031	234389	1005	0	2029642	0	1
2247	2265035	234389	1004	0	2030646	0	1
2248	2266039	234389	1004	0	2031650	0	1
2249	2267043	234389	1004	0	2032654	0	1
2250	2268048	234389	1005	0	2033659	0	1
2251	2269052	234389	1004	0	2034663	0	1
2252	2270056	234389	1004	0	2035667	0	1
2253	2271059	234389	1003	0	2036670	0	1
2254	2272063	234389	1004	0	2037674	0	1
2255	2273067	234389	1004	0	2038678	0	1
2256	2274070	234389	1003	0	2039681	0	1
2257	2275074	234389	1004	0	2040685	0	1
2258	2276079	234389	1005	0	2041690	0	1
2259	2277083	234389	1004	0	2042694	0	1
2260	2278087	234389	1004	0	2043698	0	1
2261	2279090	234389	1003	0	2044701	0	1
2262	2280094	234389	1004	0	2045705	0	1
2263	2281099	234389	1005	0	2046710	0	1
2264	2282103	234389	1004	0	2047714	0	1
2265	2283107	234389	1004	0	2048718	0	1
2266	2284110	234389	1003	0	2049721	0	1
2267	2285156	234389	1046	0	2050767	0	1
2268	2286163	234389	1007	0	2051774	0	1
2269	2287167	234389	1004	0	2052778	0	1
2270	2288172	234389	1005	0	2053783	0	1
2271	2289176	234389	1004	0	2054787	0	1
2272	2290180	234389	1004	0	2055791	0	1
2273	2291186	234389	1006	0	2056797	0	1
2274	2292190	234389	1004	0	2057801	0	1
2275	2293194	234389	1004	0	2058805	0	1
2276	2294198	234389	1004	0	2059809	0	1
2277	2295201	234389	1003	0	2060812	0	1
2278	2296206	234389	1005	0	2061817	0	1
2279	2297211	234389	1005	0	2062822	0	1
2280	2298215	234389	1004	0	2063826	0	1
2281	2299219	234389	1004	0	2064830	0	1
2282	2300223	234389	1004	0	2065834	0	1
2283	2301227	234389	1004	0	2066838	0	1
2284	2302231	234389	1004	0	2067842	0	1
2285	2303236	234389	1005	0	2068847	0	1
2286	2304241	234389	1005	0	2069852	0	1
2287	2305244	234389	1003	0	2070855	0	1
2288	2306249	234389	1005	0	2071860	0	1
2289	2307253	234389	1004	0	2072864	0	1
2290	2308257	234389	1004	0	2073868	0	1
2291	2309261	234389	1004	0	2074872	0	1
2292	2310266	234389	1005	0	2075877	0	1
2293	2311270	234389	1004	0	2076881	0	1
2294	2312274	234389	1004	0	2077885	0	1
2295	2313278	234389	1004	0	2078889	0	1
2296	2314283	234389	1005	0	2079894	0	1
2297	2315288	234389	1005	0	2080899	0	1
2298	2316291	234389	1003	0	2081902	0	1
2299	2317295	234389	1004	0	2082906	0	1
2300	2318299	234389	1004	0	2083910	0	1
2301	2319303	234389	1004	0	2084914	0	1
2302	2320306	234389	1003	0	2085917	0	1
2303	2321310	234389	1004	0	2086921	0	1
2304	2322313	234389	1003	0	2087924	0	1
2305	2323317	234389	1004	0	2088928	0	1
2306	2324322	234389	1005	0	2089933	0	1
2307	2325326	234389	1004	0	2090937	0	1
2308	2326330	234389	1004	0	2091941	0	1
2309	2327335	234389	1005	0	2092946	0	1
2310	2328340	234389	1005	0	2093951	0	1
2311	2329343	234389	1003	0	2094954	0	1
2312	2330347	234389	1004	0	2095958	0	1
2313	2331351	234389	1004	0	2096962	0	1
2314	2332356	234389	1005	0	2097967	0	1
2315	2333360	234389	1004	0	2098971	0	1
2316	2334365	234389	1005	0	2099976	0	1
2317	2335369	234389	1004	0	2100980	0	1
2318	2336373	234389	1004	0	2101984	0	1
2319	2337377	234389	1004	0	2102988	0	1
2320	2338381	234389	1004	0	2103992	0	1
2321	2339385	234389	1004	0	2104996	0	1
2322	2340389	234389	1004	0	2106000	0	1
2323	2341393	234389	1004	0	2107004	0	1
2324	2342397	234389	1004	0	2108008	0	1
2325	2343401	234389	1004	0	2109012	0	1
2326	2344406	234389	1005	0	2110017	0	1
2327	2345410	234389	1004	0	2111021	0	1
2328	2346414	234389	1004	0	2112025	0	1
2329	2347417	234389	1003	0	2113028	0	1
2330	2348422	234389	1005	0	2114033	0	1
2331	2349426	234389	1004	0	2115037	0	1
2332	2350430	234389	1004	0	2116041	0	1
2333	2351434	234389	1004	0	2117045	0	1
2334	2352438	234389	1004	0	2118049	0	1
2335	2353442	234389	1004	0	2119053	0	1
2336	2354447	234389	1005	0	2120058	0	1
2337	2355452	234389	1005	0	2121063	0	1
2338	2356455	234389	1003	0	2122066	0	1
2339	2357460	234389	1005	0	2123071	0	1
2340	2358465	234389	1005	0	2124076	0	1
2341	2359469	234389	1004	0	2125080	0	1
2342	2360474	234389	1005	0	2126085	0	1
2343	2361479	234389	1005	0	2127090	0	1
2344	2362483	234389	1004	0	2128094	0	1
2345	2363488	234389	1005	0	2129099	0	1
2346	2364493	234389	1005	0	2130104	0	1
2347	2365496	234389	1003	0	2131107	0	1
2348	2366501	234389	1005	0	2132112	0	1
2349	2367506	234389	1005	0	2133117	0	1
2350	2368510	234389	1004	0	2134121	0	1
2351	2369513	234389	1003	0	2135124	0	1
2352	2370518	234389	1005	0	2136129	0	1
2353	2371523	234389	1005	0	2137134	0	1
2354	2372528	234389	1005	0	2138139	0	1
2355	2373533	234389	1005	0	2139144	0	1
2356	2374537	234389	1004	0	2140148	0	1
2357	2375541	234389	1004	0	2141152	0	1
2358	2376546	234389	1005	0	2142157	0	1
2359	2377550	234389	1004	0	2143161	0	1
2360	2378555	234389	1005	0	2144166	0	1
2361	2379559	234389	1004	0	2145170	0	1
2362	2380562	234389	1003	0	2146173	0	1
2363	2381567	234389	1005	0	2147178	0	1
2364	2382571	234389	1004	0	2148182	0	1
2365	2383576	234389	1005	0	2149187	0	1
2366	2384580	234389	1004	0	2150191	0	1
2367	2385584	234389	1004	0	2151195	0	1
2368	2386590	234389	1006	0	2152201	0	1
2369	2387594	234389	1004	0	2153205	0	1
2370	2388598	234389	1004	0	2154209	0	1
2371	2389602	234389	1004	0	2155213	0	1
2372	2390607	234389	1005	0	2156218	0	1
2373	2391611	234389	1004	0	2157222	0	1
2374	2392616	234389	1005	0	2158227	0	1
2375	2393620	234389	1004	0	2159231	0	1
2376	2394625	234389	1005	0	2160236	0	1
2377	2395630	234389	1005	0	2161241	0	1
2378	2396635	234389	1005	0	2162246	0	1
2379	2397639	234389	1004	0	2163250	0	1
2380	2398644	234389	1005	0	2164255	0	1
2381	2399649	234389	1005	0	2165260	0	1
2382	2400654	234389	1005	0	2166265	0	1
2383	2401660	234389	1006	0	2167271	0	1
2384	2402663	234389	1003	0	2168274	0	1
2385	2403668	234389	1005	0	2169279	0	1
2386	2404673	234389	1005	0	2170284	0	1
2387	2405676	234389	1003	0	2171287	0	1
2388	2406680	234389	1004	0	2172291	0	1
2389	2407685	234389	1005	0	2173296	0	1
2390	2408690	234389	1005	0	2174301	0	1
2391	2409695	234389	1005	0	2175306	0	1
2392	2410699	234389	1004	0	2176310	0	1
2393	2411704	234389	1005	0	2177315	0	1
2394	2412709	234389	1005	0	2178320	0	1
2395	2413713	234389	1004	0	2179324	0	1
2396	2414718	234389	1005	0	2180329	0	1
2397	2415723	234389	1005	0	2181334	0	1
2398	2416727	234389	1004	0	2182338	0	1
2399	2417732	234389	1005	0	2183343	0	1
2400	2418737	234389	1005	0	2184348	0	1
2401	2419741	234389	1004	0	2185352	0	1
2402	2420746	234389	1005	0	2186357	0	1
2403	2421751	234389	1005	0	2187362	0	1
2404	2422756	234389	1005	0	2188367	0	1
2405	2423760	234389	1004	0	2189371	0	1
2406	2424764	234389	1004	0	2190375	0	1
2407	2425769	234389	1005	0	2191380	0	1
2408	2426941	234389	1172	0	2192552	0	1
2409	2427946	424894	1005	190505	2003052	1	1
2410	2428951	424894	1005	0	2004057	0	1
2411	2429956	424894	1005	0	2005062	0	1
2412	2430961	424894	1005	0	2006067	0	1
2413	2431965	424894	1004	0	2007071	0	1
2414	2432969	424894	1004	0	2008075	0	1
2415	2433974	424894	1005	0	2009080	0	1
2416	2434978	424894	1004	0	2010084	0	1
2417	2435983	424894	1005	0	2011089	0	1
2418	2436988	424894	1005	0	2012094	0	1
2419	2437993	424894	1005	0	2013099	0	1
2420	2438999	424894	1006	0	2014105	0	1
2421	2440003	424894	1004	0	2015109	0	1
2422	2441008	424894	1005	0	2016114	0	1
2423	2442012	424894	1004	0	2017118	0	1
2424	2443016	424894	1004	0	2018122	0	1
2425	2444019	424894	1003	0	2019125	0	1
2426	2445024	424894	1005	0	2020130	0	1
2427	2446029	424894	1005	0	2021135	0	1
2428	2447033	424894	1004	0	2022139	0	1
2429	2448038	424894	1005	0	2023144	0	1
2430	2449042	424894	1004	0	2024148	0	1
2431	2450046	424894	1004	0	2025152	0	1
2432	2451051	424894	1005	0	2026157	0	1
2433	2452056	424894	1005	0	2027162	0	1
2434	2453060	424894	1004	0	2028166	0	1
2435	2454064	424894	1004	0	2029170	0	1
2436	2455068	424894	1004	0	2030174	0	1
2437	2456073	424894	1005	0	2031179	0	1
2438	2457077	424894	1004	0	2032183	0	1
2439	2458082	424894	1005	0	2033188	0	1
2440	2459086	424894	1004	0	2034192	0	1
2441	2460091	424894	1005	0	2035197	0	1
2442	2461094	424894	1003	0	2036200	0	1
2443	2462099	424894	1005	0	2037205	0	1
2444	2463103	424894	1004	0	2038209	0	1
2445	2464107	424894	1004	0	2039213	0	1
2446	2465112	424894	1005	0	2040218	0	1
2447	2466119	424894	1007	0	2041225	0	1
2448	2467125	424894	1006	0	2042231	0	1
2449	2468131	424894	1006	0	2043237	0	1
2450	2469135	424894	1004	0	2044241	0	1
2451	2470140	424894	1005	0	2045246	0	1
2452	2471145	424894	1005	0	2046251	0	1
2453	2472151	424894	1006	0	2047257	0	1
2454	2473157	424894	1006	0	2048263	0	1
2455	2474161	424894	1004	0	2049267	0	1
2456	2475166	424894	1005	0	2050272	0	1
2457	2476171	424894	1005	0	2051277	0	1
2458	2477175	424894	1004	0	2052281	0	1
2459	2478179	424894	1004	0	2053285	0	1
2460	2479184	424894	1005	0	2054290	0	1
2461	2480188	424894	1004	0	2055294	0	1
2462	2481192	424894	1004	0	2056298	0	1
2463	2482196	424894	1004	0	2057302	0	1
2464	2483201	424894	1005	0	2058307	0	1
2465	2484206	424894	1005	0	2059312	0	1
2466	2485210	424894	1004	0	2060316	0	1
2467	2486214	424894	1004	0	2061320	0	1
2468	2487219	424894	1005	0	2062325	0	1
2469	2488223	424894	1004	0	2063329	0	1
2470	2489227	424894	1004	0	2064333	0	1
2471	2490231	424894	1004	0	2065337	0	1
2472	2491236	424894	1005	0	2066342	0	1
2473	2492239	424894	1003	0	2067345	0	1
2474	2493244	424894	1005	0	2068350	0	1
2475	2494247	424894	1003	0	2069353	0	1
2476	2495252	424894	1005	0	2070358	0	1
2477	2496255	424894	1003	0	2071361	0	1
2478	2497260	424894	1005	0	2072366	0	1
2479	2498263	424894	1003	0	2073369	0	1
2480	2499268	424894	1005	0	2074374	0	1
2481	2500272	424894	1004	0	2075378	0	1
2482	2501275	424894	1003	0	2076381	0	1
2483	2502280	424894	1005	0	2077386	0	1
2484	2503284	424894	1004	0	2078390	0	1
2485	2504287	424894	1003	0	2079393	0	1
2486	2505291	424894	1004	0	2080397	0	1
2487	2506295	424894	1004	0	2081401	0	1
2488	2507300	424894	1005	0	2082406	0	1
2489	2508303	424894	1003	0	2083409	0	1
2490	2509307	424894	1004	0	2084413	0	1
2491	2510312	424894	1005	0	2085418	0	1
2492	2511317	424894	1005	0	2086423	0	1
2493	2512321	424894	1004	0	2087427	0	1
2494	2513326	424894	1005	0	2088432	0	1
2495	2514330	424894	1004	0	2089436	0	1
2496	2515335	424894	1005	0	2090441	0	1
2497	2516340	424894	1005	0	2091446	0	1
2498	2517344	424894	1004	0	2092450	0	1
2499	2518349	424894	1005	0	2093455	0	1
2500	2519354	424894	1005	0	2094460	0	1
2501	2520357	424894	1003	0	2095463	0	1
2502	2521360	424894	1003	0	2096466	0	1
2503	2522365	424894	1005	0	2097471	0	1
2504	2523370	424894	1005	0	2098476	0	1
2505	2524374	424894	1004	0	2099480	0	1
2506	2525379	424894	1005	0	2100485	0	1
2507	2526384	424894	1005	0	2101490	0	1
2508	2527388	424894	1004	0	2102494	0	1
2509	2528391	424894	1003	0	2103497	0	1
2510	2529395	424894	1004	0	2104501	0	1
2511	2530400	424894	1005	0	2105506	0	1
2512	2531405	424894	1005	0	2106511	0	1
2513	2532409	424894	1004	0	2107515	0	1
2514	2533412	424894	1003	0	2108518	0	1
2515	2534416	424894	1004	0	2109522	0	1
2516	2535421	424894	1005	0	2110527	0	1
2517	2536426	424894	1005	0	2111532	0	1
2518	2537432	424894	1006	0	2112538	0	1
2519	2538437	424894	1005	0	2113543	0	1
2520	2539441	424894	1004	0	2114547	0	1
2521	2540445	424894	1004	0	2115551	0	1
2522	2541449	424894	1004	0	2116555	0	1
2523	2542453	424894	1004	0	2117559	0	1
2524	2543458	424894	1005	0	2118564	0	1
2525	2544463	424894	1005	0	2119569	0	1
2526	2545467	424894	1004	0	2120573	0	1
2527	2546472	424894	1005	0	2121578	0	1
2528	2547476	424894	1004	0	2122582	0	1
2529	2548481	424894	1005	0	2123587	0	1
2530	2549485	424894	1004	0	2124591	0	1
2531	2550488	424894	1003	0	2125594	0	1
2532	2551493	424894	1005	0	2126599	0	1
2533	2552498	424894	1005	0	2127604	0	1
2534	2553501	424894	1003	0	2128607	0	1
2535	2554505	424894	1004	0	2129611	0	1
2536	2555509	424894	1004	0	2130615	0	1
2537	2556514	424894	1005	0	2131620	0	1
2538	2557519	424894	1005	0	2132625	0	1
2539	2558523	424894	1004	0	2133629	0	1
2540	2559528	424894	1005	0	2134634	0	1
2541	2560532	424894	1004	0	2135638	0	1
2542	2561537	424894	1005	0	2136643	0	1
2543	2562542	424894	1005	0	2137648	0	1
2544	2563545	424894	1003	0	2138651	0	1
2545	2564549	424894	1004	0	2139655	0	1
2546	2565552	424894	1003	0	2140658	0	1
2547	2566556	424894	1004	0	2141662	0	1
2548	2567560	424894	1004	0	2142666	0	1
2549	2568564	424894	1004	0	2143670	0	1
2550	2569567	424894	1003	0	2144673	0	1
2551	2570573	424894	1006	0	2145679	0	1
2552	2571577	424894	1004	0	2146683	0	1
2553	2572580	424894	1003	0	2147686	0	1
2554	2573585	424894	1005	0	2148691	0	1
